"","experiment","condition","subj_id","scale_range","sequence_type","true_arithmetic_mean","pre_obs_estimate","post_obs_estimate","delta_estimate"
"1","exp1A","sparse_below_average","exp1A_sub001",300,"training",150.225,90,140,50
"2","exp1A","sparse_below_average","exp1A_sub001",300,"test",152.461538461538,142,130,-12
"3","exp1A","sparse_below_average","exp1A_sub002",300,"training",150.225,10,170,160
"4","exp1A","sparse_below_average","exp1A_sub002",300,"test",150.225,150,162,12
"5","exp1A","sparse_below_average","exp1A_sub003",300,"training",150.225,61,147,86
"6","exp1A","sparse_below_average","exp1A_sub003",300,"test",150.225,160,171,11
"7","exp1A","sparse_below_average","exp1A_sub004",300,"training",150.225,158,143,-15
"8","exp1A","sparse_below_average","exp1A_sub004",300,"test",150.225,160,171,11
"9","exp1A","sparse_below_average","exp1A_sub005",300,"training",150.225,81,146,65
"10","exp1A","sparse_below_average","exp1A_sub005",300,"test",149.846153846154,136,122,-14
"11","exp1A","sparse_below_average","exp1A_sub006",300,"training",150.225,104,151,47
"12","exp1A","sparse_below_average","exp1A_sub006",300,"test",150.225,144,146,2
"13","exp1A","sparse_below_average","exp1A_sub007",300,"training",150.225,100,120,20
"14","exp1A","sparse_below_average","exp1A_sub007",300,"test",150.225,150,148,-2
"15","exp1A","sparse_below_average","exp1A_sub008",300,"training",150.225,46,147,101
"16","exp1A","sparse_below_average","exp1A_sub008",300,"test",149.461538461538,158,137,-21
"17","exp1A","sparse_below_average","exp1A_sub009",300,"training",150.225,220,150,-70
"18","exp1A","sparse_below_average","exp1A_sub009",300,"test",150.225,150,95,-55
"19","exp1A","sparse_below_average","exp1A_sub010",300,"training",150.225,300,134,-166
"20","exp1A","sparse_below_average","exp1A_sub010",300,"test",149.487179487179,138,155,17
"21","exp1A","sparse_below_average","exp1A_sub011",300,"training",150.225,50,150,100
"22","exp1A","sparse_below_average","exp1A_sub011",300,"test",150.225,150,140,-10
"23","exp1A","sparse_below_average","exp1A_sub012",300,"training",150.225,6,150,144
"24","exp1A","sparse_below_average","exp1A_sub012",300,"test",150.225,150,125,-25
"25","exp1A","sparse_below_average","exp1A_sub013",300,"training",150.225,173,146,-27
"26","exp1A","sparse_below_average","exp1A_sub013",300,"test",150.225,154,153,-1
"27","exp1A","sparse_below_average","exp1A_sub014",300,"training",150.225,151,165,14
"28","exp1A","sparse_below_average","exp1A_sub014",300,"test",150.225,143,158,15
"29","exp1A","sparse_below_average","exp1A_sub015",300,"training",150.225,32,150,118
"30","exp1A","sparse_below_average","exp1A_sub015",300,"test",149.564102564103,150,150,0
"31","exp1A","sparse_below_average","exp1A_sub016",300,"training",150.225,42,150,108
"32","exp1A","sparse_below_average","exp1A_sub016",300,"test",150.225,121,105,-16
"33","exp1A","sparse_below_average","exp1A_sub017",300,"training",150.225,32,150,118
"34","exp1A","sparse_below_average","exp1A_sub017",300,"test",150.225,150,130,-20
"35","exp1A","sparse_below_average","exp1A_sub018",300,"training",150.225,32,156,124
"36","exp1A","sparse_below_average","exp1A_sub018",300,"test",150.225,156,124,-32
"37","exp1A","sparse_below_average","exp1A_sub019",300,"training",150.225,48,116,68
"38","exp1A","sparse_below_average","exp1A_sub019",300,"test",150.225,151,79,-72
"39","exp1A","sparse_below_average","exp1A_sub020",300,"training",150.225,181,168,-13
"40","exp1A","sparse_below_average","exp1A_sub020",300,"test",149.692307692308,159,162,3
"41","exp1A","sparse_below_average","exp1A_sub021",300,"training",150.225,40,146,106
"42","exp1A","sparse_below_average","exp1A_sub021",300,"test",149.948717948718,140,170,30
"43","exp1A","sparse_below_average","exp1A_sub022",300,"training",150.225,50,109,59
"44","exp1A","sparse_below_average","exp1A_sub022",300,"test",150.225,130,154,24
"45","exp1A","sparse_below_average","exp1A_sub023",300,"training",150.225,25,150,125
"46","exp1A","sparse_below_average","exp1A_sub023",300,"test",150.076923076923,139,154,15
"47","exp1A","sparse_below_average","exp1A_sub024",300,"training",150.225,120,150,30
"48","exp1A","sparse_below_average","exp1A_sub024",300,"test",150.225,150,154,4
"49","exp1A","sparse_below_average","exp1A_sub025",300,"training",150.225,112,154,42
"50","exp1A","sparse_below_average","exp1A_sub025",300,"test",150.225,150,151,1
"51","exp1A","sparse_below_average","exp1A_sub026",300,"training",150.225,119,158,39
"52","exp1A","sparse_below_average","exp1A_sub026",300,"test",150.358974358974,152,159,7
"53","exp1A","sparse_below_average","exp1A_sub027",300,"training",150.225,36,141,105
"54","exp1A","sparse_below_average","exp1A_sub027",300,"test",150.225,145,86,-59
"55","exp1A","sparse_below_average","exp1A_sub028",300,"training",150.225,90,169,79
"56","exp1A","sparse_below_average","exp1A_sub028",300,"test",149.923076923077,158,151,-7
"57","exp1A","sparse_below_average","exp1A_sub029",300,"training",150.225,120,155,35
"58","exp1A","sparse_below_average","exp1A_sub029",300,"test",150.358974358974,164,162,-2
"59","exp1A","sparse_below_average","exp1A_sub030",300,"training",150.225,90,160,70
"60","exp1A","sparse_below_average","exp1A_sub030",300,"test",150.225,160,160,0
"61","exp1A","sparse_below_average","exp1A_sub031",300,"training",150.225,6,141,135
"62","exp1A","sparse_below_average","exp1A_sub031",300,"test",150.225,146,152,6
"63","exp1A","sparse_below_average","exp1A_sub032",300,"training",150.225,120,144,24
"64","exp1A","sparse_below_average","exp1A_sub032",300,"test",149.564102564103,144,121,-23
"65","exp1A","sparse_below_average","exp1A_sub033",300,"training",150.225,195,162,-33
"66","exp1A","sparse_below_average","exp1A_sub033",300,"test",149.692307692308,140,177,37
"67","exp1A","sparse_below_average","exp1A_sub034",300,"training",150.225,88,151,63
"68","exp1A","sparse_below_average","exp1A_sub034",300,"test",149.435897435897,150,121,-29
"69","exp1A","sparse_above_average","exp1A_sub035",300,"training",150.225,154,133,-21
"70","exp1A","sparse_above_average","exp1A_sub035",300,"test",149.775,150,150,0
"71","exp1A","sparse_above_average","exp1A_sub036",300,"training",150.225,64,150,86
"72","exp1A","sparse_above_average","exp1A_sub036",300,"test",149.775,152,168,16
"73","exp1A","sparse_above_average","exp1A_sub037",300,"training",150.225,100,160,60
"74","exp1A","sparse_above_average","exp1A_sub037",300,"test",149.775,165,160,-5
"75","exp1A","sparse_above_average","exp1A_sub038",300,"training",150.225,89,129,40
"76","exp1A","sparse_above_average","exp1A_sub038",300,"test",147.589743589744,157,158,1
"77","exp1A","sparse_above_average","exp1A_sub039",300,"training",150.225,148,170,22
"78","exp1A","sparse_above_average","exp1A_sub039",300,"test",150.666666666667,164,161,-3
"79","exp1A","sparse_above_average","exp1A_sub040",300,"training",150.225,30,150,120
"80","exp1A","sparse_above_average","exp1A_sub040",300,"test",149.775,150,135,-15
"81","exp1A","sparse_above_average","exp1A_sub041",300,"training",150.225,89,151,62
"82","exp1A","sparse_above_average","exp1A_sub041",300,"test",149.775,150,150,0
"83","exp1A","sparse_above_average","exp1A_sub042",300,"training",150.225,182,151,-31
"84","exp1A","sparse_above_average","exp1A_sub042",300,"test",147.589743589744,153,151,-2
"85","exp1A","sparse_above_average","exp1A_sub043",300,"training",150.225,71,149,78
"86","exp1A","sparse_above_average","exp1A_sub043",300,"test",150.051282051282,166,189,23
"87","exp1A","sparse_above_average","exp1A_sub044",300,"training",150.225,25,125,100
"88","exp1A","sparse_above_average","exp1A_sub044",300,"test",149.775,155,125,-30
"89","exp1A","sparse_above_average","exp1A_sub045",300,"training",150.225,127,139,12
"90","exp1A","sparse_above_average","exp1A_sub045",300,"test",149.775,168,155,-13
"91","exp1A","sparse_above_average","exp1A_sub046",300,"training",150.225,58,184,126
"92","exp1A","sparse_above_average","exp1A_sub046",300,"test",150.051282051282,166,168,2
"93","exp1A","sparse_above_average","exp1A_sub047",300,"training",150.225,112,135,23
"94","exp1A","sparse_above_average","exp1A_sub047",300,"test",149.775,146,132,-14
"95","exp1A","sparse_above_average","exp1A_sub048",300,"training",150.225,100,142,42
"96","exp1A","sparse_above_average","exp1A_sub048",300,"test",149.775,150,140,-10
"97","exp1A","sparse_above_average","exp1A_sub049",300,"training",150.225,210,150,-60
"98","exp1A","sparse_above_average","exp1A_sub049",300,"test",149.775,171,150,-21
"99","exp1A","sparse_above_average","exp1A_sub050",300,"training",150.225,59,221,162
"100","exp1A","sparse_above_average","exp1A_sub050",300,"test",150.051282051282,146,221,75
"101","exp1A","sparse_above_average","exp1A_sub051",300,"training",150.225,114,152,38
"102","exp1A","sparse_above_average","exp1A_sub051",300,"test",147.538461538462,150,155,5
"103","exp1A","sparse_above_average","exp1A_sub052",300,"training",150.225,121,140,19
"104","exp1A","sparse_above_average","exp1A_sub052",300,"test",149.775,150,155,5
"105","exp1A","sparse_above_average","exp1A_sub053",300,"training",150.225,129,190,61
"106","exp1A","sparse_above_average","exp1A_sub053",300,"test",150.564102564103,149,176,27
"107","exp1A","sparse_above_average","exp1A_sub054",300,"training",150.225,31,124,93
"108","exp1A","sparse_above_average","exp1A_sub054",300,"test",149.775,150,163,13
"109","exp1A","sparse_above_average","exp1A_sub055",300,"training",150.225,127,155,28
"110","exp1A","sparse_above_average","exp1A_sub055",300,"test",150.538461538462,149,151,2
"111","exp1A","sparse_above_average","exp1A_sub056",300,"training",150.225,175,160,-15
"112","exp1A","sparse_above_average","exp1A_sub056",300,"test",149.775,140,175,35
"113","exp1A","sparse_above_average","exp1A_sub057",300,"training",150.225,111,117,6
"114","exp1A","sparse_above_average","exp1A_sub057",300,"test",150.153846153846,152,159,7
"115","exp1A","sparse_above_average","exp1A_sub058",300,"training",150.225,154,136,-18
"116","exp1A","sparse_above_average","exp1A_sub058",300,"test",150.435897435897,138,151,13
"117","exp1A","sparse_above_average","exp1A_sub059",300,"training",150.225,151,160,9
"118","exp1A","sparse_above_average","exp1A_sub059",300,"test",149.775,150,144,-6
"119","exp1A","sparse_above_average","exp1A_sub060",300,"training",150.225,100,149,49
"120","exp1A","sparse_above_average","exp1A_sub060",300,"test",149.775,145,181,36
"121","exp1A","sparse_above_average","exp1A_sub061",300,"training",150.225,181,159,-22
"122","exp1A","sparse_above_average","exp1A_sub061",300,"test",149.775,161,175,14
"123","exp1A","sparse_above_average","exp1A_sub062",300,"training",150.225,181,211,30
"124","exp1A","sparse_above_average","exp1A_sub062",300,"test",149.775,152,179,27
"125","exp1A","sparse_above_average","exp1A_sub063",300,"training",150.225,120,139,19
"126","exp1A","sparse_above_average","exp1A_sub063",300,"test",149.775,140,171,31
"127","exp1A","sparse_above_average","exp1A_sub064",300,"training",150.225,53,150,97
"128","exp1A","sparse_above_average","exp1A_sub064",300,"test",149.775,120,125,5
"129","exp1A","sparse_above_average","exp1A_sub065",300,"training",150.225,146,152,6
"130","exp1A","sparse_above_average","exp1A_sub065",300,"test",150.076923076923,152,149,-3
"131","exp1A","sparse_above_average","exp1A_sub066",300,"training",150.225,88,150,62
"132","exp1A","sparse_above_average","exp1A_sub066",300,"test",149.775,161,171,10
"133","exp1A","sparse_above_average","exp1A_sub067",300,"training",150.225,150,150,0
"134","exp1A","sparse_above_average","exp1A_sub067",300,"test",149.775,150,150,0
"135","exp1A","sparse_above_average","exp1A_sub068",300,"training",150.225,100,150,50
"136","exp1A","sparse_above_average","exp1A_sub068",300,"test",149.775,120,135,15
"137","exp1A","sparse_above_average","exp1A_sub069",300,"training",150.225,94,150,56
"138","exp1A","sparse_above_average","exp1A_sub069",300,"test",149.775,150,150,0
"139","exp1A","sparse_above_average","exp1A_sub070",300,"training",150.225,91,137,46
"140","exp1A","sparse_above_average","exp1A_sub070",300,"test",149.775,139,148,9
"141","exp1A","sparse_above_average","exp1A_sub071",300,"training",150.225,86,131,45
"142","exp1A","sparse_above_average","exp1A_sub071",300,"test",150.410256410256,128,145,17
"143","exp1A","sparse_above_average","exp1A_sub072",300,"training",150.225,117,120,3
"144","exp1A","sparse_above_average","exp1A_sub072",300,"test",149.775,150,150,0
"145","exp1A","sparse_above_average","exp1A_sub073",300,"training",150.225,107,145,38
"146","exp1A","sparse_above_average","exp1A_sub073",300,"test",149.775,150,150,0
"147","exp1A","sparse_above_average","exp1A_sub074",300,"training",150.225,210,128,-82
"148","exp1A","sparse_above_average","exp1A_sub074",300,"test",149.775,147,169,22
"149","exp1A","sparse_above_average","exp1A_sub075",300,"training",150.225,50,141,91
"150","exp1A","sparse_above_average","exp1A_sub075",300,"test",149.775,140,162,22
"151","exp1A","sparse_above_average","exp1A_sub076",300,"training",150.225,212,150,-62
"152","exp1A","sparse_above_average","exp1A_sub076",300,"test",149.775,159,155,-4
"153","exp1B","sparse_below_average","exp1B_sub001",300,"training",150.225,120,150,30
"154","exp1B","sparse_below_average","exp1B_sub001",300,"test",150.225,150,165,15
"155","exp1B","sparse_below_average","exp1B_sub002",300,"training",150.225,50,150,100
"156","exp1B","sparse_below_average","exp1B_sub002",300,"test",150.225,125,162,37
"157","exp1B","sparse_below_average","exp1B_sub003",300,"training",150.225,150,171,21
"158","exp1B","sparse_below_average","exp1B_sub003",300,"test",150.225,156,162,6
"159","exp1B","sparse_below_average","exp1B_sub004",300,"training",150.225,188,136,-52
"160","exp1B","sparse_below_average","exp1B_sub004",300,"test",150.225,156,151,-5
"161","exp1B","sparse_below_average","exp1B_sub005",300,"training",150.225,160,150,-10
"162","exp1B","sparse_below_average","exp1B_sub005",300,"test",150.225,150,146,-4
"163","exp1B","sparse_below_average","exp1B_sub006",300,"training",150.225,69,116,47
"164","exp1B","sparse_below_average","exp1B_sub006",300,"test",150.225,120,151,31
"165","exp1B","sparse_below_average","exp1B_sub007",300,"training",150.225,90,150,60
"166","exp1B","sparse_below_average","exp1B_sub007",300,"test",150.225,150,153,3
"167","exp1B","sparse_below_average","exp1B_sub008",300,"training",150.225,118,143,25
"168","exp1B","sparse_below_average","exp1B_sub008",300,"test",150.225,159,169,10
"169","exp1B","sparse_below_average","exp1B_sub009",300,"training",150.225,148,150,2
"170","exp1B","sparse_below_average","exp1B_sub009",300,"test",150.225,170,160,-10
"171","exp1B","sparse_below_average","exp1B_sub010",300,"training",150.225,135,148,13
"172","exp1B","sparse_below_average","exp1B_sub010",300,"test",150.225,148,161,13
"173","exp1B","sparse_above_average","exp1B_sub011",300,"training",150.225,20,130,110
"174","exp1B","sparse_above_average","exp1B_sub011",300,"test",149.775,120,125,5
"175","exp1B","sparse_above_average","exp1B_sub012",300,"training",150.225,160,139,-21
"176","exp1B","sparse_above_average","exp1B_sub012",300,"test",149.775,142,170,28
"177","exp1B","sparse_above_average","exp1B_sub013",300,"training",150.225,68,135,67
"178","exp1B","sparse_above_average","exp1B_sub013",300,"test",149.775,150,151,1
"179","exp1B","sparse_above_average","exp1B_sub014",300,"training",150.225,120,170,50
"180","exp1B","sparse_above_average","exp1B_sub014",300,"test",149.775,152,168,16
"181","exp1B","sparse_above_average","exp1B_sub015",300,"training",150.225,108,156,48
"182","exp1B","sparse_above_average","exp1B_sub015",300,"test",149.775,142,134,-8
"183","exp1B","sparse_above_average","exp1B_sub016",300,"training",150.225,37,161,124
"184","exp1B","sparse_above_average","exp1B_sub016",300,"test",149.775,164,151,-13
"185","exp1B","sparse_above_average","exp1B_sub017",300,"training",150.225,50,151,101
"186","exp1B","sparse_above_average","exp1B_sub017",300,"test",149.775,151,165,14
"187","exp1B","sparse_above_average","exp1B_sub018",300,"training",150.225,300,149,-151
"188","exp1B","sparse_above_average","exp1B_sub018",300,"test",149.775,150,147,-3
"189","exp1B","sparse_above_average","exp1B_sub019",300,"training",150.225,11,138,127
"190","exp1B","sparse_above_average","exp1B_sub019",300,"test",149.775,156,161,5
"191","exp1B","sparse_above_average","exp1B_sub020",300,"training",150.225,91,155,64
"192","exp1B","sparse_above_average","exp1B_sub020",300,"test",149.775,150,128,-22
"193","exp1B","sparse_above_average","exp1B_sub021",300,"training",150.225,125,141,16
"194","exp1B","sparse_above_average","exp1B_sub021",300,"test",149.775,152,156,4
"195","exp1B","sparse_above_average","exp1B_sub022",300,"training",150.225,200,157,-43
"196","exp1B","sparse_above_average","exp1B_sub022",300,"test",149.775,155,170,15
"197","exp2A-1","sparse_below_average","exp2A-1_sub001",500,"training",248,200,240,40
"198","exp2A-1","sparse_below_average","exp2A-1_sub001",500,"test",248,244,228,-16
"199","exp2A-1","sparse_below_average","exp2A-1_sub002",500,"training",248,200,268,68
"200","exp2A-1","sparse_below_average","exp2A-1_sub002",500,"test",248,250,239,-11
"201","exp2A-1","sparse_below_average","exp2A-1_sub003",500,"training",248,202,222,20
"202","exp2A-1","sparse_below_average","exp2A-1_sub003",500,"test",248,251,245,-6
"203","exp2A-1","sparse_below_average","exp2A-1_sub004",500,"training",248,400,240,-160
"204","exp2A-1","sparse_below_average","exp2A-1_sub004",500,"test",248,250,260,10
"205","exp2A-1","sparse_below_average","exp2A-1_sub005",500,"training",248,117,248,131
"206","exp2A-1","sparse_below_average","exp2A-1_sub005",500,"test",248,212,222,10
"207","exp2A-1","sparse_below_average","exp2A-1_sub006",500,"training",248,281,204,-77
"208","exp2A-1","sparse_below_average","exp2A-1_sub006",500,"test",248,238,151,-87
"209","exp2A-1","sparse_below_average","exp2A-1_sub007",500,"training",248,301,256,-45
"210","exp2A-1","sparse_below_average","exp2A-1_sub007",500,"test",248,250,229,-21
"211","exp2A-1","sparse_below_average","exp2A-1_sub008",500,"training",248,100,230,130
"212","exp2A-1","sparse_below_average","exp2A-1_sub008",500,"test",248,230,248,18
"213","exp2A-1","sparse_below_average","exp2A-1_sub009",500,"training",248,86,236,150
"214","exp2A-1","sparse_below_average","exp2A-1_sub009",500,"test",248,232,183,-49
"215","exp2A-1","sparse_below_average","exp2A-1_sub010",500,"training",248,200,220,20
"216","exp2A-1","sparse_below_average","exp2A-1_sub010",500,"test",248,240,275,35
"217","exp2A-1","sparse_below_average","exp2A-1_sub011",500,"training",248,250,294,44
"218","exp2A-1","sparse_below_average","exp2A-1_sub011",500,"test",248,241,248,7
"219","exp2A-1","sparse_below_average","exp2A-1_sub012",500,"training",248,107,212,105
"220","exp2A-1","sparse_below_average","exp2A-1_sub012",500,"test",248,250,217,-33
"221","exp2A-1","sparse_below_average","exp2A-1_sub013",500,"training",248,200,249,49
"222","exp2A-1","sparse_below_average","exp2A-1_sub013",500,"test",248,251,253,2
"223","exp2A-1","sparse_below_average","exp2A-1_sub014",500,"training",248,200,248,48
"224","exp2A-1","sparse_below_average","exp2A-1_sub014",500,"test",248,253,262,9
"225","exp2A-1","sparse_below_average","exp2A-1_sub015",500,"training",248,250,244,-6
"226","exp2A-1","sparse_below_average","exp2A-1_sub015",500,"test",248,245,269,24
"227","exp2A-1","sparse_below_average","exp2A-1_sub016",500,"training",248,52,198,146
"228","exp2A-1","sparse_below_average","exp2A-1_sub016",500,"test",248,239,274,35
"229","exp2A-1","sparse_below_average","exp2A-1_sub017",500,"training",248,250,247,-3
"230","exp2A-1","sparse_below_average","exp2A-1_sub017",500,"test",248,248,284,36
"231","exp2A-1","sparse_below_average","exp2A-1_sub018",500,"training",248,303,236,-67
"232","exp2A-1","sparse_below_average","exp2A-1_sub018",500,"test",248,252,244,-8
"233","exp2A-1","sparse_below_average","exp2A-1_sub019",500,"training",248,261,257,-4
"234","exp2A-1","sparse_below_average","exp2A-1_sub019",500,"test",248,249,183,-66
"235","exp2A-1","sparse_below_average","exp2A-1_sub020",500,"training",248,500,207,-293
"236","exp2A-1","sparse_below_average","exp2A-1_sub020",500,"test",248,254,260,6
"237","exp2A-1","sparse_below_average","exp2A-1_sub021",500,"training",248,300,254,-46
"238","exp2A-1","sparse_below_average","exp2A-1_sub021",500,"test",248,275,222,-53
"239","exp2A-1","sparse_below_average","exp2A-1_sub022",500,"training",248,5,250,245
"240","exp2A-1","sparse_below_average","exp2A-1_sub022",500,"test",248,250,200,-50
"241","exp2A-1","sparse_below_average","exp2A-1_sub023",500,"training",248,150,225,75
"242","exp2A-1","sparse_below_average","exp2A-1_sub023",500,"test",248,263,280,17
"243","exp2A-1","sparse_below_average","exp2A-1_sub024",500,"training",248,200,243,43
"244","exp2A-1","sparse_below_average","exp2A-1_sub024",500,"test",248,252,213,-39
"245","exp2A-1","sparse_below_average","exp2A-1_sub025",500,"training",248,200,249,49
"246","exp2A-1","sparse_below_average","exp2A-1_sub025",500,"test",248,248,172,-76
"247","exp2A-1","sparse_below_average","exp2A-1_sub026",500,"training",248,184,265,81
"248","exp2A-1","sparse_below_average","exp2A-1_sub026",500,"test",248,230,231,1
"249","exp2A-1","sparse_above_average","exp2A-1_sub027",500,"training",252,102,240,138
"250","exp2A-1","sparse_above_average","exp2A-1_sub027",500,"test",252,255,270,15
"251","exp2A-1","sparse_above_average","exp2A-1_sub028",500,"training",252,99,210,111
"252","exp2A-1","sparse_above_average","exp2A-1_sub028",500,"test",252,234,250,16
"253","exp2A-1","sparse_above_average","exp2A-1_sub029",500,"training",252,250,253,3
"254","exp2A-1","sparse_above_average","exp2A-1_sub029",500,"test",252,250,241,-9
"255","exp2A-1","sparse_above_average","exp2A-1_sub030",500,"training",252,150,244,94
"256","exp2A-1","sparse_above_average","exp2A-1_sub030",500,"test",252,250,280,30
"257","exp2A-1","sparse_above_average","exp2A-1_sub031",500,"training",252,40,250,210
"258","exp2A-1","sparse_above_average","exp2A-1_sub031",500,"test",252,250,230,-20
"259","exp2A-1","sparse_above_average","exp2A-1_sub032",500,"training",252,4,250,246
"260","exp2A-1","sparse_above_average","exp2A-1_sub032",500,"test",252,252,260,8
"261","exp2A-1","sparse_above_average","exp2A-1_sub033",500,"training",252,200,241,41
"262","exp2A-1","sparse_above_average","exp2A-1_sub033",500,"test",252,247,258,11
"263","exp2A-1","sparse_above_average","exp2A-1_sub034",500,"training",252,328,259,-69
"264","exp2A-1","sparse_above_average","exp2A-1_sub034",500,"test",252,249,237,-12
"265","exp2A-1","sparse_above_average","exp2A-1_sub035",500,"training",252,100,250,150
"266","exp2A-1","sparse_above_average","exp2A-1_sub035",500,"test",252,200,315,115
"267","exp2A-1","sparse_above_average","exp2A-1_sub036",500,"training",252,30,250,220
"268","exp2A-1","sparse_above_average","exp2A-1_sub036",500,"test",252,250,200,-50
"269","exp2A-1","sparse_above_average","exp2A-1_sub037",500,"training",252,250,229,-21
"270","exp2A-1","sparse_above_average","exp2A-1_sub037",500,"test",252,242,250,8
"271","exp2A-1","sparse_above_average","exp2A-1_sub038",500,"training",252,350,230,-120
"272","exp2A-1","sparse_above_average","exp2A-1_sub038",500,"test",252,303,260,-43
"273","exp2A-1","sparse_above_average","exp2A-1_sub039",500,"training",252,175,225,50
"274","exp2A-1","sparse_above_average","exp2A-1_sub039",500,"test",252,225,249,24
"275","exp2A-1","sparse_above_average","exp2A-1_sub040",500,"training",252,309,229,-80
"276","exp2A-1","sparse_above_average","exp2A-1_sub040",500,"test",252,230,253,23
"277","exp2A-1","sparse_above_average","exp2A-1_sub041",500,"training",252,301,210,-91
"278","exp2A-1","sparse_above_average","exp2A-1_sub041",500,"test",252,234,225,-9
"279","exp2A-1","sparse_above_average","exp2A-1_sub042",500,"training",252,250,250,0
"280","exp2A-1","sparse_above_average","exp2A-1_sub042",500,"test",252,250,250,0
"281","exp2A-1","sparse_above_average","exp2A-1_sub043",500,"training",252,300,250,-50
"282","exp2A-1","sparse_above_average","exp2A-1_sub043",500,"test",252,236,230,-6
"283","exp2A-1","sparse_above_average","exp2A-1_sub044",500,"training",252,100,235,135
"284","exp2A-1","sparse_above_average","exp2A-1_sub044",500,"test",252,265,240,-25
"285","exp2A-1","sparse_above_average","exp2A-1_sub045",500,"training",252,200,250,50
"286","exp2A-1","sparse_above_average","exp2A-1_sub045",500,"test",252,250,275,25
"287","exp2A-1","sparse_above_average","exp2A-1_sub046",500,"training",252,243,246,3
"288","exp2A-1","sparse_above_average","exp2A-1_sub046",500,"test",252,257,250,-7
"289","exp2A-1","sparse_above_average","exp2A-1_sub047",500,"training",252,172,223,51
"290","exp2A-1","sparse_above_average","exp2A-1_sub047",500,"test",252,251,288,37
"291","exp2A-1","sparse_above_average","exp2A-1_sub048",500,"training",252,200,240,40
"292","exp2A-1","sparse_above_average","exp2A-1_sub048",500,"test",252,250,270,20
"293","exp2A-1","sparse_above_average","exp2A-1_sub049",500,"training",252,100,216,116
"294","exp2A-1","sparse_above_average","exp2A-1_sub049",500,"test",252,239,270,31
"295","exp2A-1","sparse_above_average","exp2A-1_sub050",500,"training",252,100,218,118
"296","exp2A-1","sparse_above_average","exp2A-1_sub050",500,"test",252,243,236,-7
"297","exp2A-1","sparse_above_average","exp2A-1_sub051",500,"training",252,166,192,26
"298","exp2A-1","sparse_above_average","exp2A-1_sub051",500,"test",252,252,270,18
"299","exp2A-1","sparse_above_average","exp2A-1_sub052",500,"training",252,100,250,150
"300","exp2A-1","sparse_above_average","exp2A-1_sub052",500,"test",252,200,250,50
"301","exp2A-1","sparse_above_average","exp2A-1_sub053",500,"training",252,250,285,35
"302","exp2A-1","sparse_above_average","exp2A-1_sub053",500,"test",252,275,298,23
"303","exp2A-1","sparse_above_average","exp2A-1_sub054",500,"training",252,266,221,-45
"304","exp2A-1","sparse_above_average","exp2A-1_sub054",500,"test",252,246,290,44
"305","exp2A-1","sparse_above_average","exp2A-1_sub055",500,"training",252,200,257,57
"306","exp2A-1","sparse_above_average","exp2A-1_sub055",500,"test",252,251,180,-71
"307","exp2A-1","sparse_above_average","exp2A-1_sub056",500,"training",252,100,241,141
"308","exp2A-1","sparse_above_average","exp2A-1_sub056",500,"test",252,255,220,-35
"309","exp2A-1","sparse_above_average","exp2A-1_sub057",500,"training",252,299,239,-60
"310","exp2A-1","sparse_above_average","exp2A-1_sub057",500,"test",252,255,239,-16
"311","exp2A-1","sparse_above_average","exp2A-1_sub058",500,"training",252,100,225,125
"312","exp2A-1","sparse_above_average","exp2A-1_sub058",500,"test",252,250,282,32
"313","exp2A-1","sparse_above_average","exp2A-1_sub059",500,"training",252,12,210,198
"314","exp2A-1","sparse_above_average","exp2A-1_sub059",500,"test",252,213,239,26
"315","exp2A-1","sparse_above_average","exp2A-1_sub060",500,"training",252,500,205,-295
"316","exp2A-1","sparse_above_average","exp2A-1_sub060",500,"test",252,250,257,7
"317","exp2A-1","sparse_above_average","exp2A-1_sub061",500,"training",252,266,235,-31
"318","exp2A-1","sparse_above_average","exp2A-1_sub061",500,"test",252,253,280,27
"319","exp2A-1","sparse_above_average","exp2A-1_sub062",500,"training",252,350,260,-90
"320","exp2A-1","sparse_above_average","exp2A-1_sub062",500,"test",252,260,250,-10
"321","exp2A-1","sparse_above_average","exp2A-1_sub063",500,"training",252,200,225,25
"322","exp2A-1","sparse_above_average","exp2A-1_sub063",500,"test",252,233,256,23
"323","exp2A-1","sparse_above_average","exp2A-1_sub064",500,"training",252,250,243,-7
"324","exp2A-1","sparse_above_average","exp2A-1_sub064",500,"test",252,244,268,24
"325","exp2A-1","sparse_above_average","exp2A-1_sub065",500,"training",252,102,245,143
"326","exp2A-1","sparse_above_average","exp2A-1_sub065",500,"test",252,233,185,-48
"327","exp2A-1","sparse_above_average","exp2A-1_sub066",500,"training",252,200,240,40
"328","exp2A-1","sparse_above_average","exp2A-1_sub066",500,"test",252,248,300,52
"329","exp2A-1","sparse_above_average","exp2A-1_sub067",500,"training",252,300,299,-1
"330","exp2A-1","sparse_above_average","exp2A-1_sub067",500,"test",252,245,245,0
"331","exp2A-1","sparse_above_average","exp2A-1_sub068",500,"training",252,108,250,142
"332","exp2A-1","sparse_above_average","exp2A-1_sub068",500,"test",252,253,250,-3
"333","exp2A-1","sparse_above_average","exp2A-1_sub069",500,"training",252,200,250,50
"334","exp2A-1","sparse_above_average","exp2A-1_sub069",500,"test",252,250,300,50
"335","exp2A-1","sparse_above_average","exp2A-1_sub070",500,"training",252,250,242,-8
"336","exp2A-1","sparse_above_average","exp2A-1_sub070",500,"test",252,250,280,30
"337","exp2A-2","sparse_below_average","exp2A-2_sub001",500,"training",248,101,215,114
"338","exp2A-2","sparse_below_average","exp2A-2_sub001",500,"test",248,242,242,0
"339","exp2A-2","sparse_below_average","exp2A-2_sub002",500,"training",248,200,222,22
"340","exp2A-2","sparse_below_average","exp2A-2_sub002",500,"test",248,221,294,73
"341","exp2A-2","sparse_below_average","exp2A-2_sub003",500,"training",248,250,250,0
"342","exp2A-2","sparse_below_average","exp2A-2_sub003",500,"test",248,250,185,-65
"343","exp2A-2","sparse_below_average","exp2A-2_sub004",500,"training",248,500,245,-255
"344","exp2A-2","sparse_below_average","exp2A-2_sub004",500,"test",248,240,202,-38
"345","exp2A-2","sparse_below_average","exp2A-2_sub005",500,"training",248,112,250,138
"346","exp2A-2","sparse_below_average","exp2A-2_sub005",500,"test",248,251,250,-1
"347","exp2A-2","sparse_below_average","exp2A-2_sub006",500,"training",248,301,250,-51
"348","exp2A-2","sparse_below_average","exp2A-2_sub006",500,"test",248,250,225,-25
"349","exp2A-2","sparse_below_average","exp2A-2_sub007",500,"training",248,50,240,190
"350","exp2A-2","sparse_below_average","exp2A-2_sub007",500,"test",248,240,236,-4
"351","exp2A-2","sparse_below_average","exp2A-2_sub008",500,"training",248,225,216,-9
"352","exp2A-2","sparse_below_average","exp2A-2_sub008",500,"test",248,225,229,4
"353","exp2A-2","sparse_below_average","exp2A-2_sub009",500,"training",248,31,261,230
"354","exp2A-2","sparse_below_average","exp2A-2_sub009",500,"test",248,230,242,12
"355","exp2A-2","sparse_below_average","exp2A-2_sub010",500,"training",248,40,186,146
"356","exp2A-2","sparse_below_average","exp2A-2_sub010",500,"test",248,192,176,-16
"357","exp2A-2","sparse_below_average","exp2A-2_sub011",500,"training",248,235,261,26
"358","exp2A-2","sparse_below_average","exp2A-2_sub011",500,"test",248,253,242,-11
"359","exp2A-2","sparse_below_average","exp2A-2_sub012",500,"training",248,250,250,0
"360","exp2A-2","sparse_below_average","exp2A-2_sub012",500,"test",248,250,250,0
"361","exp2A-2","sparse_below_average","exp2A-2_sub013",500,"training",248,100,244,144
"362","exp2A-2","sparse_below_average","exp2A-2_sub013",500,"test",248,245,228,-17
"363","exp2A-2","sparse_below_average","exp2A-2_sub014",500,"training",248,75,250,175
"364","exp2A-2","sparse_below_average","exp2A-2_sub014",500,"test",248,250,250,0
"365","exp2A-2","sparse_below_average","exp2A-2_sub015",500,"training",248,251,252,1
"366","exp2A-2","sparse_below_average","exp2A-2_sub015",500,"test",248,251,251,0
"367","exp2A-2","sparse_below_average","exp2A-2_sub016",500,"training",248,297,260,-37
"368","exp2A-2","sparse_below_average","exp2A-2_sub016",500,"test",248,241,252,11
"369","exp2A-2","sparse_below_average","exp2A-2_sub017",500,"training",248,195,183,-12
"370","exp2A-2","sparse_below_average","exp2A-2_sub017",500,"test",248,237,215,-22
"371","exp2A-2","sparse_below_average","exp2A-2_sub018",500,"training",248,100,240,140
"372","exp2A-2","sparse_below_average","exp2A-2_sub018",500,"test",248,249,243,-6
"373","exp2A-2","sparse_below_average","exp2A-2_sub019",500,"training",248,25,225,200
"374","exp2A-2","sparse_below_average","exp2A-2_sub019",500,"test",248,230,240,10
"375","exp2A-2","sparse_below_average","exp2A-2_sub020",500,"training",248,102,242,140
"376","exp2A-2","sparse_below_average","exp2A-2_sub020",500,"test",248,265,211,-54
"377","exp2A-2","sparse_below_average","exp2A-2_sub021",500,"training",248,100,205,105
"378","exp2A-2","sparse_below_average","exp2A-2_sub021",500,"test",248,233,253,20
"379","exp2A-2","sparse_below_average","exp2A-2_sub022",500,"training",248,189,240,51
"380","exp2A-2","sparse_below_average","exp2A-2_sub022",500,"test",248,239,200,-39
"381","exp2A-2","sparse_below_average","exp2A-2_sub023",500,"training",248,326,255,-71
"382","exp2A-2","sparse_below_average","exp2A-2_sub023",500,"test",248,265,233,-32
"383","exp2A-2","sparse_below_average","exp2A-2_sub024",500,"training",248,306,246,-60
"384","exp2A-2","sparse_below_average","exp2A-2_sub024",500,"test",248,248,254,6
"385","exp2A-2","sparse_below_average","exp2A-2_sub025",500,"training",248,300,256,-44
"386","exp2A-2","sparse_below_average","exp2A-2_sub025",500,"test",248,270,196,-74
"387","exp2A-2","sparse_below_average","exp2A-2_sub026",500,"training",248,200,255,55
"388","exp2A-2","sparse_below_average","exp2A-2_sub026",500,"test",248,255,255,0
"389","exp2A-2","sparse_below_average","exp2A-2_sub027",500,"training",248,257,229,-28
"390","exp2A-2","sparse_below_average","exp2A-2_sub027",500,"test",248,245,289,44
"391","exp2A-2","sparse_below_average","exp2A-2_sub028",500,"training",248,201,215,14
"392","exp2A-2","sparse_below_average","exp2A-2_sub028",500,"test",248,251,275,24
"393","exp2A-2","sparse_above_average","exp2A-2_sub029",500,"training",252,326,250,-76
"394","exp2A-2","sparse_above_average","exp2A-2_sub029",500,"test",252,233,228,-5
"395","exp2A-2","sparse_above_average","exp2A-2_sub030",500,"training",252,301,216,-85
"396","exp2A-2","sparse_above_average","exp2A-2_sub030",500,"test",252,257,288,31
"397","exp2A-2","sparse_above_average","exp2A-2_sub031",500,"training",252,400,240,-160
"398","exp2A-2","sparse_above_average","exp2A-2_sub031",500,"test",252,240,225,-15
"399","exp2A-2","sparse_above_average","exp2A-2_sub032",500,"training",252,182,211,29
"400","exp2A-2","sparse_above_average","exp2A-2_sub032",500,"test",252,233,247,14
"401","exp2A-2","sparse_above_average","exp2A-2_sub033",500,"training",252,150,254,104
"402","exp2A-2","sparse_above_average","exp2A-2_sub033",500,"test",252,250,252,2
"403","exp2A-2","sparse_above_average","exp2A-2_sub034",500,"training",252,200,220,20
"404","exp2A-2","sparse_above_average","exp2A-2_sub034",500,"test",252,260,270,10
"405","exp2A-2","sparse_above_average","exp2A-2_sub035",500,"training",252,212,245,33
"406","exp2A-2","sparse_above_average","exp2A-2_sub035",500,"test",252,250,250,0
"407","exp2A-2","sparse_above_average","exp2A-2_sub036",500,"training",252,155,250,95
"408","exp2A-2","sparse_above_average","exp2A-2_sub036",500,"test",252,252,301,49
"409","exp2A-2","sparse_above_average","exp2A-2_sub037",500,"training",252,236,236,0
"410","exp2A-2","sparse_above_average","exp2A-2_sub037",500,"test",252,251,267,16
"411","exp2A-2","sparse_above_average","exp2A-2_sub038",500,"training",252,150,240,90
"412","exp2A-2","sparse_above_average","exp2A-2_sub038",500,"test",252,250,300,50
"413","exp2A-2","sparse_above_average","exp2A-2_sub039",500,"training",252,146,232,86
"414","exp2A-2","sparse_above_average","exp2A-2_sub039",500,"test",252,244,234,-10
"415","exp2A-2","sparse_above_average","exp2A-2_sub040",500,"training",252,250,244,-6
"416","exp2A-2","sparse_above_average","exp2A-2_sub040",500,"test",252,246,277,31
"417","exp2A-2","sparse_above_average","exp2A-2_sub041",500,"training",252,201,240,39
"418","exp2A-2","sparse_above_average","exp2A-2_sub041",500,"test",252,250,279,29
"419","exp2A-2","sparse_above_average","exp2A-2_sub042",500,"training",252,100,246,146
"420","exp2A-2","sparse_above_average","exp2A-2_sub042",500,"test",252,248,264,16
"421","exp2A-2","sparse_above_average","exp2A-2_sub043",500,"training",252,279,230,-49
"422","exp2A-2","sparse_above_average","exp2A-2_sub043",500,"test",252,252,264,12
"423","exp2A-2","sparse_above_average","exp2A-2_sub044",500,"training",252,347,241,-106
"424","exp2A-2","sparse_above_average","exp2A-2_sub044",500,"test",252,252,260,8
"425","exp2A-2","sparse_above_average","exp2A-2_sub045",500,"training",252,150,250,100
"426","exp2A-2","sparse_above_average","exp2A-2_sub045",500,"test",252,251,250,-1
"427","exp2A-2","sparse_above_average","exp2A-2_sub046",500,"training",252,202,246,44
"428","exp2A-2","sparse_above_average","exp2A-2_sub046",500,"test",252,241,236,-5
"429","exp2A-2","sparse_above_average","exp2A-2_sub047",500,"training",252,251,251,0
"430","exp2A-2","sparse_above_average","exp2A-2_sub047",500,"test",252,249,250,1
"431","exp2A-2","sparse_above_average","exp2A-2_sub048",500,"training",252,200,239,39
"432","exp2A-2","sparse_above_average","exp2A-2_sub048",500,"test",252,206,264,58
"433","exp2A-2","sparse_above_average","exp2A-2_sub049",500,"training",252,264,251,-13
"434","exp2A-2","sparse_above_average","exp2A-2_sub049",500,"test",252,250,223,-27
"435","exp2A-2","sparse_above_average","exp2A-2_sub050",500,"training",252,122,249,127
"436","exp2A-2","sparse_above_average","exp2A-2_sub050",500,"test",252,246,276,30
"437","exp2A-2","sparse_above_average","exp2A-2_sub051",500,"training",252,196,258,62
"438","exp2A-2","sparse_above_average","exp2A-2_sub051",500,"test",252,242,237,-5
"439","exp2A-2","sparse_above_average","exp2A-2_sub052",500,"training",252,317,227,-90
"440","exp2A-2","sparse_above_average","exp2A-2_sub052",500,"test",252,254,291,37
"441","exp2A-2","sparse_above_average","exp2A-2_sub053",500,"training",252,100,250,150
"442","exp2A-2","sparse_above_average","exp2A-2_sub053",500,"test",252,250,276,26
"443","exp2A-2","sparse_above_average","exp2A-2_sub054",500,"training",252,250,250,0
"444","exp2A-2","sparse_above_average","exp2A-2_sub054",500,"test",252,300,275,-25
"445","exp2A-2","sparse_above_average","exp2A-2_sub055",500,"training",252,200,250,50
"446","exp2A-2","sparse_above_average","exp2A-2_sub055",500,"test",252,240,200,-40
"447","exp2A-2","sparse_above_average","exp2A-2_sub056",500,"training",252,364,253,-111
"448","exp2A-2","sparse_above_average","exp2A-2_sub056",500,"test",252,253,263,10
"449","exp2A-2","sparse_above_average","exp2A-2_sub057",500,"training",252,101,233,132
"450","exp2A-2","sparse_above_average","exp2A-2_sub057",500,"test",252,249,270,21
"451","exp2A-2","sparse_above_average","exp2A-2_sub058",500,"training",252,300,239,-61
"452","exp2A-2","sparse_above_average","exp2A-2_sub058",500,"test",252,249,300,51
"453","exp2A-2","sparse_above_average","exp2A-2_sub059",500,"training",252,100,231,131
"454","exp2A-2","sparse_above_average","exp2A-2_sub059",500,"test",252,250,272,22
"455","exp2A-2","sparse_above_average","exp2A-2_sub060",500,"training",252,200,250,50
"456","exp2A-2","sparse_above_average","exp2A-2_sub060",500,"test",252,301,250,-51
"457","exp2A-2","sparse_above_average","exp2A-2_sub061",500,"training",252,251,215,-36
"458","exp2A-2","sparse_above_average","exp2A-2_sub061",500,"test",252,263,260,-3
"459","exp2A-2","sparse_above_average","exp2A-2_sub062",500,"training",252,395,197,-198
"460","exp2A-2","sparse_above_average","exp2A-2_sub062",500,"test",252,205,204,-1
"461","exp2A-2","sparse_above_average","exp2A-2_sub063",500,"training",252,250,255,5
"462","exp2A-2","sparse_above_average","exp2A-2_sub063",500,"test",252,255,325,70
"463","exp2A-2","sparse_above_average","exp2A-2_sub064",500,"training",252,150,269,119
"464","exp2A-2","sparse_above_average","exp2A-2_sub064",500,"test",252,220,224,4
"465","exp2A-2","sparse_above_average","exp2A-2_sub065",500,"training",252,150,253,103
"466","exp2A-2","sparse_above_average","exp2A-2_sub065",500,"test",252,230,212,-18
"467","exp2A-2","sparse_above_average","exp2A-2_sub066",500,"training",252,200,247,47
"468","exp2A-2","sparse_above_average","exp2A-2_sub066",500,"test",252,251,220,-31
"469","exp2A-2","sparse_above_average","exp2A-2_sub067",500,"training",252,350,238,-112
"470","exp2A-2","sparse_above_average","exp2A-2_sub067",500,"test",252,243,205,-38
"471","exp2A-3","sparse_below_average","exp2A-3_sub001",500,"training",248,25,250,225
"472","exp2A-3","sparse_below_average","exp2A-3_sub001",500,"test",248,279,300,21
"473","exp2A-3","sparse_below_average","exp2A-3_sub002",500,"training",248,300,250,-50
"474","exp2A-3","sparse_below_average","exp2A-3_sub002",500,"test",248,250,300,50
"475","exp2A-3","sparse_below_average","exp2A-3_sub003",500,"training",248,150,250,100
"476","exp2A-3","sparse_below_average","exp2A-3_sub003",500,"test",248,250,250,0
"477","exp2A-3","sparse_below_average","exp2A-3_sub004",500,"training",248,250,260,10
"478","exp2A-3","sparse_below_average","exp2A-3_sub004",500,"test",248,250,245,-5
"479","exp2A-3","sparse_below_average","exp2A-3_sub005",500,"training",248,250,260,10
"480","exp2A-3","sparse_below_average","exp2A-3_sub005",500,"test",248,250,245,-5
"481","exp2A-3","sparse_below_average","exp2A-3_sub006",500,"training",248,200,250,50
"482","exp2A-3","sparse_below_average","exp2A-3_sub006",500,"test",248,250,225,-25
"483","exp2A-3","sparse_below_average","exp2A-3_sub007",500,"training",248,300,300,0
"484","exp2A-3","sparse_below_average","exp2A-3_sub007",500,"test",248,300,300,0
"485","exp2A-3","sparse_below_average","exp2A-3_sub008",500,"training",248,50,250,200
"486","exp2A-3","sparse_below_average","exp2A-3_sub008",500,"test",248,245,250,5
"487","exp2A-3","sparse_below_average","exp2A-3_sub009",500,"training",248,300,252,-48
"488","exp2A-3","sparse_below_average","exp2A-3_sub009",500,"test",248,255,245,-10
"489","exp2A-3","sparse_below_average","exp2A-3_sub010",500,"training",248,300,300,0
"490","exp2A-3","sparse_below_average","exp2A-3_sub010",500,"test",248,250,200,-50
"491","exp2A-3","sparse_below_average","exp2A-3_sub011",500,"training",248,200,250,50
"492","exp2A-3","sparse_below_average","exp2A-3_sub011",500,"test",248,250,235,-15
"493","exp2A-3","sparse_below_average","exp2A-3_sub012",500,"training",248,4,230,226
"494","exp2A-3","sparse_below_average","exp2A-3_sub012",500,"test",248,235,240,5
"495","exp2A-3","sparse_below_average","exp2A-3_sub013",500,"training",248,200,225,25
"496","exp2A-3","sparse_below_average","exp2A-3_sub013",500,"test",248,225,225,0
"497","exp2A-3","sparse_below_average","exp2A-3_sub014",500,"training",248,2,250,248
"498","exp2A-3","sparse_below_average","exp2A-3_sub014",500,"test",248,250,200,-50
"499","exp2A-3","sparse_below_average","exp2A-3_sub015",500,"training",248,200,250,50
"500","exp2A-3","sparse_below_average","exp2A-3_sub015",500,"test",248,250,240,-10
"501","exp2A-3","sparse_below_average","exp2A-3_sub016",500,"training",248,250,254,4
"502","exp2A-3","sparse_below_average","exp2A-3_sub016",500,"test",248,254,218,-36
"503","exp2A-3","sparse_below_average","exp2A-3_sub017",500,"training",248,200,250,50
"504","exp2A-3","sparse_below_average","exp2A-3_sub017",500,"test",248,250,230,-20
"505","exp2A-3","sparse_below_average","exp2A-3_sub018",500,"training",248,200,250,50
"506","exp2A-3","sparse_below_average","exp2A-3_sub018",500,"test",248,250,250,0
"507","exp2A-3","sparse_below_average","exp2A-3_sub019",500,"training",248,5,240,235
"508","exp2A-3","sparse_below_average","exp2A-3_sub019",500,"test",248,260,180,-80
"509","exp2A-3","sparse_below_average","exp2A-3_sub020",500,"training",248,200,200,0
"510","exp2A-3","sparse_below_average","exp2A-3_sub020",500,"test",248,200,250,50
"511","exp2A-3","sparse_below_average","exp2A-3_sub021",500,"training",248,200,240,40
"512","exp2A-3","sparse_below_average","exp2A-3_sub021",500,"test",248,240,230,-10
"513","exp2A-3","sparse_below_average","exp2A-3_sub022",500,"training",248,100,220,120
"514","exp2A-3","sparse_below_average","exp2A-3_sub022",500,"test",248,250,265,15
"515","exp2A-3","sparse_below_average","exp2A-3_sub023",500,"training",248,200,200,0
"516","exp2A-3","sparse_below_average","exp2A-3_sub023",500,"test",248,250,215,-35
"517","exp2A-3","sparse_below_average","exp2A-3_sub024",500,"training",248,200,250,50
"518","exp2A-3","sparse_below_average","exp2A-3_sub024",500,"test",248,250,200,-50
"519","exp2A-3","sparse_below_average","exp2A-3_sub025",500,"training",248,100,250,150
"520","exp2A-3","sparse_below_average","exp2A-3_sub025",500,"test",248,250,235,-15
"521","exp2A-3","sparse_below_average","exp2A-3_sub026",500,"training",248,350,250,-100
"522","exp2A-3","sparse_below_average","exp2A-3_sub026",500,"test",248,245,260,15
"523","exp2A-3","sparse_below_average","exp2A-3_sub027",500,"training",248,300,265,-35
"524","exp2A-3","sparse_below_average","exp2A-3_sub027",500,"test",248,260,215,-45
"525","exp2A-3","sparse_below_average","exp2A-3_sub028",500,"training",248,10,200,190
"526","exp2A-3","sparse_below_average","exp2A-3_sub028",500,"test",248,250,250,0
"527","exp2A-3","sparse_below_average","exp2A-3_sub029",500,"training",248,150,225,75
"528","exp2A-3","sparse_below_average","exp2A-3_sub029",500,"test",248,245,245,0
"529","exp2A-3","sparse_below_average","exp2A-3_sub030",500,"training",248,2,200,198
"530","exp2A-3","sparse_below_average","exp2A-3_sub030",500,"test",248,250,225,-25
"531","exp2A-3","sparse_below_average","exp2A-3_sub031",500,"training",248,100,300,200
"532","exp2A-3","sparse_below_average","exp2A-3_sub031",500,"test",248,250,250,0
"533","exp2A-3","sparse_below_average","exp2A-3_sub032",500,"training",248,200,225,25
"534","exp2A-3","sparse_below_average","exp2A-3_sub032",500,"test",248,240,224,-16
"535","exp2A-3","sparse_below_average","exp2A-3_sub033",500,"training",248,350,240,-110
"536","exp2A-3","sparse_below_average","exp2A-3_sub033",500,"test",248,240,250,10
"537","exp2A-3","sparse_below_average","exp2A-3_sub034",500,"training",248,300,265,-35
"538","exp2A-3","sparse_below_average","exp2A-3_sub034",500,"test",248,250,245,-5
"539","exp2A-3","sparse_below_average","exp2A-3_sub035",500,"training",248,10,220,210
"540","exp2A-3","sparse_below_average","exp2A-3_sub035",500,"test",248,245,240,-5
"541","exp2A-3","sparse_below_average","exp2A-3_sub036",500,"training",248,200,230,30
"542","exp2A-3","sparse_below_average","exp2A-3_sub036",500,"test",248,230,259,29
"543","exp2A-3","sparse_below_average","exp2A-3_sub037",500,"training",248,250,247,-3
"544","exp2A-3","sparse_below_average","exp2A-3_sub037",500,"test",248,248,250,2
"545","exp2A-3","sparse_below_average","exp2A-3_sub038",500,"training",248,250,220,-30
"546","exp2A-3","sparse_below_average","exp2A-3_sub038",500,"test",248,230,215,-15
"547","exp2A-3","sparse_below_average","exp2A-3_sub039",500,"training",248,200,250,50
"548","exp2A-3","sparse_below_average","exp2A-3_sub039",500,"test",248,250,280,30
"549","exp2A-3","sparse_below_average","exp2A-3_sub040",500,"training",248,310,235,-75
"550","exp2A-3","sparse_below_average","exp2A-3_sub040",500,"test",248,243,258,15
"551","exp2A-3","sparse_below_average","exp2A-3_sub041",500,"training",248,200,240,40
"552","exp2A-3","sparse_below_average","exp2A-3_sub041",500,"test",248,240,275,35
"553","exp2A-3","sparse_below_average","exp2A-3_sub042",500,"training",248,250,250,0
"554","exp2A-3","sparse_below_average","exp2A-3_sub042",500,"test",248,250,275,25
"555","exp2A-3","sparse_below_average","exp2A-3_sub043",500,"training",248,225,250,25
"556","exp2A-3","sparse_below_average","exp2A-3_sub043",500,"test",248,240,225,-15
"557","exp2A-3","sparse_below_average","exp2A-3_sub044",500,"training",248,5,230,225
"558","exp2A-3","sparse_below_average","exp2A-3_sub044",500,"test",248,230,250,20
"559","exp2A-3","sparse_below_average","exp2A-3_sub045",500,"training",248,200,245,45
"560","exp2A-3","sparse_below_average","exp2A-3_sub045",500,"test",248,250,220,-30
"561","exp2A-3","sparse_below_average","exp2A-3_sub046",500,"training",248,175,230,55
"562","exp2A-3","sparse_below_average","exp2A-3_sub046",500,"test",248,240,240,0
"563","exp2A-3","sparse_below_average","exp2A-3_sub047",500,"training",248,150,250,100
"564","exp2A-3","sparse_below_average","exp2A-3_sub047",500,"test",248,250,157,-93
"565","exp2A-3","sparse_below_average","exp2A-3_sub048",500,"training",248,250,240,-10
"566","exp2A-3","sparse_below_average","exp2A-3_sub048",500,"test",248,240,272,32
"567","exp2A-3","sparse_below_average","exp2A-3_sub049",500,"training",248,200,250,50
"568","exp2A-3","sparse_below_average","exp2A-3_sub049",500,"test",248,250,250,0
"569","exp2A-3","sparse_below_average","exp2A-3_sub050",500,"training",248,100,250,150
"570","exp2A-3","sparse_below_average","exp2A-3_sub050",500,"test",248,240,200,-40
"571","exp2A-3","sparse_below_average","exp2A-3_sub051",500,"training",248,200,230,30
"572","exp2A-3","sparse_below_average","exp2A-3_sub051",500,"test",248,250,260,10
"573","exp2A-3","sparse_below_average","exp2A-3_sub052",500,"training",248,50,250,200
"574","exp2A-3","sparse_below_average","exp2A-3_sub052",500,"test",248,250,225,-25
"575","exp2A-3","sparse_below_average","exp2A-3_sub053",500,"training",248,20,250,230
"576","exp2A-3","sparse_below_average","exp2A-3_sub053",500,"test",248,250,250,0
"577","exp2A-3","sparse_below_average","exp2A-3_sub054",500,"training",248,200,300,100
"578","exp2A-3","sparse_below_average","exp2A-3_sub054",500,"test",248,260,230,-30
"579","exp2A-3","sparse_below_average","exp2A-3_sub055",500,"training",248,200,230,30
"580","exp2A-3","sparse_below_average","exp2A-3_sub055",500,"test",248,255,255,0
"581","exp2A-3","sparse_below_average","exp2A-3_sub056",500,"training",248,200,275,75
"582","exp2A-3","sparse_below_average","exp2A-3_sub056",500,"test",248,250,300,50
"583","exp2A-3","sparse_below_average","exp2A-3_sub057",500,"training",248,250,250,0
"584","exp2A-3","sparse_below_average","exp2A-3_sub057",500,"test",248,250,225,-25
"585","exp2A-3","sparse_below_average","exp2A-3_sub058",500,"training",248,100,290,190
"586","exp2A-3","sparse_below_average","exp2A-3_sub058",500,"test",248,250,280,30
"587","exp2A-3","sparse_below_average","exp2A-3_sub059",500,"training",248,100,250,150
"588","exp2A-3","sparse_below_average","exp2A-3_sub059",500,"test",248,250,243,-7
"589","exp2A-3","sparse_below_average","exp2A-3_sub060",500,"training",248,100,240,140
"590","exp2A-3","sparse_below_average","exp2A-3_sub060",500,"test",248,230,215,-15
"591","exp2A-3","sparse_below_average","exp2A-3_sub061",500,"training",248,150,245,95
"592","exp2A-3","sparse_below_average","exp2A-3_sub061",500,"test",248,240,270,30
"593","exp2A-3","sparse_below_average","exp2A-3_sub062",500,"training",248,200,200,0
"594","exp2A-3","sparse_below_average","exp2A-3_sub062",500,"test",248,240,210,-30
"595","exp2A-3","sparse_below_average","exp2A-3_sub063",500,"training",248,100,245,145
"596","exp2A-3","sparse_below_average","exp2A-3_sub063",500,"test",248,254,255,1
"597","exp2A-3","sparse_below_average","exp2A-3_sub064",500,"training",248,50,245,195
"598","exp2A-3","sparse_below_average","exp2A-3_sub064",500,"test",248,240,230,-10
"599","exp2A-3","sparse_below_average","exp2A-3_sub065",500,"training",248,300,250,-50
"600","exp2A-3","sparse_below_average","exp2A-3_sub065",500,"test",248,250,215,-35
"601","exp2A-3","sparse_below_average","exp2A-3_sub066",500,"training",248,250,250,0
"602","exp2A-3","sparse_below_average","exp2A-3_sub066",500,"test",248,250,250,0
"603","exp2A-3","sparse_below_average","exp2A-3_sub067",500,"training",248,100,225,125
"604","exp2A-3","sparse_below_average","exp2A-3_sub067",500,"test",248,230,250,20
"605","exp2A-3","sparse_below_average","exp2A-3_sub068",500,"training",248,100,200,100
"606","exp2A-3","sparse_below_average","exp2A-3_sub068",500,"test",248,250,250,0
"607","exp2A-3","sparse_below_average","exp2A-3_sub069",500,"training",248,200,252,52
"608","exp2A-3","sparse_below_average","exp2A-3_sub069",500,"test",248,252,235,-17
"609","exp2A-3","sparse_below_average","exp2A-3_sub070",500,"training",248,50,240,190
"610","exp2A-3","sparse_below_average","exp2A-3_sub070",500,"test",248,250,220,-30
"611","exp2A-3","sparse_below_average","exp2A-3_sub071",500,"training",248,250,250,0
"612","exp2A-3","sparse_below_average","exp2A-3_sub071",500,"test",248,250,250,0
"613","exp2A-3","sparse_below_average","exp2A-3_sub072",500,"training",248,500,250,-250
"614","exp2A-3","sparse_below_average","exp2A-3_sub072",500,"test",248,250,285,35
"615","exp2A-3","sparse_below_average","exp2A-3_sub073",500,"training",248,200,235,35
"616","exp2A-3","sparse_below_average","exp2A-3_sub073",500,"test",248,245,285,40
"617","exp2A-3","sparse_below_average","exp2A-3_sub074",500,"training",248,350,235,-115
"618","exp2A-3","sparse_below_average","exp2A-3_sub074",500,"test",248,230,225,-5
"619","exp2A-3","sparse_below_average","exp2A-3_sub075",500,"training",248,350,250,-100
"620","exp2A-3","sparse_below_average","exp2A-3_sub075",500,"test",248,245,240,-5
"621","exp2A-3","sparse_below_average","exp2A-3_sub076",500,"training",248,200,250,50
"622","exp2A-3","sparse_below_average","exp2A-3_sub076",500,"test",248,250,242,-8
"623","exp2A-3","sparse_below_average","exp2A-3_sub077",500,"training",248,300,255,-45
"624","exp2A-3","sparse_below_average","exp2A-3_sub077",500,"test",248,255,270,15
"625","exp2A-3","sparse_below_average","exp2A-3_sub078",500,"training",248,400,200,-200
"626","exp2A-3","sparse_below_average","exp2A-3_sub078",500,"test",248,200,230,30
"627","exp2A-3","sparse_below_average","exp2A-3_sub079",500,"training",248,100,240,140
"628","exp2A-3","sparse_below_average","exp2A-3_sub079",500,"test",248,240,220,-20
"629","exp2A-3","sparse_below_average","exp2A-3_sub080",500,"training",248,200,250,50
"630","exp2A-3","sparse_below_average","exp2A-3_sub080",500,"test",248,250,250,0
"631","exp2A-3","sparse_below_average","exp2A-3_sub081",500,"training",248,250,300,50
"632","exp2A-3","sparse_below_average","exp2A-3_sub081",500,"test",248,250,250,0
"633","exp2A-3","sparse_below_average","exp2A-3_sub082",500,"training",248,25,250,225
"634","exp2A-3","sparse_below_average","exp2A-3_sub082",500,"test",248,250,200,-50
"635","exp2A-3","sparse_below_average","exp2A-3_sub083",500,"training",248,100,255,155
"636","exp2A-3","sparse_below_average","exp2A-3_sub083",500,"test",248,255,255,0
"637","exp2A-3","sparse_below_average","exp2A-3_sub084",500,"training",248,3,275,272
"638","exp2A-3","sparse_below_average","exp2A-3_sub084",500,"test",248,250,180,-70
"639","exp2A-3","sparse_below_average","exp2A-3_sub085",500,"training",248,250,250,0
"640","exp2A-3","sparse_below_average","exp2A-3_sub085",500,"test",248,250,260,10
"641","exp2A-3","sparse_below_average","exp2A-3_sub086",500,"training",248,250,250,0
"642","exp2A-3","sparse_below_average","exp2A-3_sub086",500,"test",248,250,225,-25
"643","exp2A-3","sparse_below_average","exp2A-3_sub087",500,"training",248,150,222,72
"644","exp2A-3","sparse_below_average","exp2A-3_sub087",500,"test",248,244,200,-44
"645","exp2A-3","sparse_below_average","exp2A-3_sub088",500,"training",248,175,250,75
"646","exp2A-3","sparse_below_average","exp2A-3_sub088",500,"test",248,250,225,-25
"647","exp2A-3","sparse_below_average","exp2A-3_sub089",500,"training",248,300,300,0
"648","exp2A-3","sparse_below_average","exp2A-3_sub089",500,"test",248,250,250,0
"649","exp2A-3","sparse_below_average","exp2A-3_sub090",500,"training",248,100,220,120
"650","exp2A-3","sparse_below_average","exp2A-3_sub090",500,"test",248,233,222,-11
"651","exp2A-3","sparse_below_average","exp2A-3_sub091",500,"training",248,20,200,180
"652","exp2A-3","sparse_below_average","exp2A-3_sub091",500,"test",248,250,250,0
"653","exp2A-3","sparse_below_average","exp2A-3_sub092",500,"training",248,200,250,50
"654","exp2A-3","sparse_below_average","exp2A-3_sub092",500,"test",248,250,250,0
"655","exp2A-3","sparse_below_average","exp2A-3_sub093",500,"training",248,200,230,30
"656","exp2A-3","sparse_below_average","exp2A-3_sub093",500,"test",248,230,250,20
"657","exp2A-3","sparse_below_average","exp2A-3_sub094",500,"training",248,50,250,200
"658","exp2A-3","sparse_below_average","exp2A-3_sub094",500,"test",248,240,240,0
"659","exp2A-3","sparse_below_average","exp2A-3_sub095",500,"training",248,200,220,20
"660","exp2A-3","sparse_below_average","exp2A-3_sub095",500,"test",248,220,280,60
"661","exp2A-3","sparse_below_average","exp2A-3_sub096",500,"training",248,300,315,15
"662","exp2A-3","sparse_below_average","exp2A-3_sub096",500,"test",248,300,250,-50
"663","exp2A-3","sparse_below_average","exp2A-3_sub097",500,"training",248,250,250,0
"664","exp2A-3","sparse_below_average","exp2A-3_sub097",500,"test",248,250,250,0
"665","exp2A-3","sparse_below_average","exp2A-3_sub098",500,"training",248,100,250,150
"666","exp2A-3","sparse_below_average","exp2A-3_sub098",500,"test",248,250,330,80
"667","exp2A-3","sparse_below_average","exp2A-3_sub099",500,"training",248,300,230,-70
"668","exp2A-3","sparse_below_average","exp2A-3_sub099",500,"test",248,240,250,10
"669","exp2A-3","sparse_below_average","exp2A-3_sub100",500,"training",248,5,257,252
"670","exp2A-3","sparse_below_average","exp2A-3_sub100",500,"test",248,256,250,-6
"671","exp2A-3","sparse_below_average","exp2A-3_sub101",500,"training",248,200,220,20
"672","exp2A-3","sparse_below_average","exp2A-3_sub101",500,"test",248,250,260,10
"673","exp2A-3","sparse_below_average","exp2A-3_sub102",500,"training",248,100,250,150
"674","exp2A-3","sparse_below_average","exp2A-3_sub102",500,"test",248,250,250,0
"675","exp2A-3","sparse_below_average","exp2A-3_sub103",500,"training",248,175,234,59
"676","exp2A-3","sparse_below_average","exp2A-3_sub103",500,"test",248,260,165,-95
"677","exp2A-3","sparse_below_average","exp2A-3_sub104",500,"training",248,100,250,150
"678","exp2A-3","sparse_below_average","exp2A-3_sub104",500,"test",248,250,280,30
"679","exp2A-3","sparse_below_average","exp2A-3_sub105",500,"training",248,100,300,200
"680","exp2A-3","sparse_below_average","exp2A-3_sub105",500,"test",248,260,250,-10
"681","exp2A-3","sparse_below_average","exp2A-3_sub106",500,"training",248,300,260,-40
"682","exp2A-3","sparse_below_average","exp2A-3_sub106",500,"test",248,260,200,-60
"683","exp2A-3","sparse_below_average","exp2A-3_sub107",500,"training",248,50,225,175
"684","exp2A-3","sparse_below_average","exp2A-3_sub107",500,"test",248,220,315,95
"685","exp2A-3","sparse_below_average","exp2A-3_sub108",500,"training",248,250,250,0
"686","exp2A-3","sparse_below_average","exp2A-3_sub108",500,"test",248,250,275,25
"687","exp2A-3","sparse_below_average","exp2A-3_sub109",500,"training",248,2,250,248
"688","exp2A-3","sparse_below_average","exp2A-3_sub109",500,"test",248,230,200,-30
"689","exp2A-3","sparse_below_average","exp2A-3_sub110",500,"training",248,200,250,50
"690","exp2A-3","sparse_below_average","exp2A-3_sub110",500,"test",248,250,260,10
"691","exp2A-3","sparse_below_average","exp2A-3_sub111",500,"training",248,250,250,0
"692","exp2A-3","sparse_below_average","exp2A-3_sub111",500,"test",248,250,250,0
"693","exp2A-3","sparse_below_average","exp2A-3_sub112",500,"training",248,150,250,100
"694","exp2A-3","sparse_below_average","exp2A-3_sub112",500,"test",248,250,250,0
"695","exp2A-3","sparse_below_average","exp2A-3_sub113",500,"training",248,100,215,115
"696","exp2A-3","sparse_below_average","exp2A-3_sub113",500,"test",248,250,160,-90
"697","exp2A-3","sparse_below_average","exp2A-3_sub114",500,"training",248,200,240,40
"698","exp2A-3","sparse_below_average","exp2A-3_sub114",500,"test",248,250,280,30
"699","exp2A-3","sparse_below_average","exp2A-3_sub115",500,"training",248,250,250,0
"700","exp2A-3","sparse_below_average","exp2A-3_sub115",500,"test",248,250,278,28
"701","exp2A-3","sparse_below_average","exp2A-3_sub116",500,"training",248,100,250,150
"702","exp2A-3","sparse_below_average","exp2A-3_sub116",500,"test",248,235,260,25
"703","exp2A-3","sparse_below_average","exp2A-3_sub117",500,"training",248,300,240,-60
"704","exp2A-3","sparse_below_average","exp2A-3_sub117",500,"test",248,240,250,10
"705","exp2A-3","sparse_below_average","exp2A-3_sub118",500,"training",248,100,280,180
"706","exp2A-3","sparse_below_average","exp2A-3_sub118",500,"test",248,250,250,0
"707","exp2A-3","sparse_below_average","exp2A-3_sub119",500,"training",248,100,245,145
"708","exp2A-3","sparse_below_average","exp2A-3_sub119",500,"test",248,250,215,-35
"709","exp2A-3","sparse_below_average","exp2A-3_sub120",500,"training",248,15,240,225
"710","exp2A-3","sparse_below_average","exp2A-3_sub120",500,"test",248,240,250,10
"711","exp2A-3","sparse_below_average","exp2A-3_sub121",500,"training",248,3,253,250
"712","exp2A-3","sparse_below_average","exp2A-3_sub121",500,"test",248,230,200,-30
"713","exp2A-3","sparse_below_average","exp2A-3_sub122",500,"training",248,100,250,150
"714","exp2A-3","sparse_below_average","exp2A-3_sub122",500,"test",248,254,275,21
"715","exp2A-3","sparse_below_average","exp2A-3_sub123",500,"training",248,250,240,-10
"716","exp2A-3","sparse_below_average","exp2A-3_sub123",500,"test",248,240,260,20
"717","exp2A-3","sparse_below_average","exp2A-3_sub124",500,"training",248,100,250,150
"718","exp2A-3","sparse_below_average","exp2A-3_sub124",500,"test",248,250,250,0
"719","exp2A-3","sparse_below_average","exp2A-3_sub125",500,"training",248,150,245,95
"720","exp2A-3","sparse_below_average","exp2A-3_sub125",500,"test",248,250,235,-15
"721","exp2A-3","sparse_below_average","exp2A-3_sub126",500,"training",248,150,250,100
"722","exp2A-3","sparse_below_average","exp2A-3_sub126",500,"test",248,250,237,-13
"723","exp2A-3","sparse_below_average","exp2A-3_sub127",500,"training",248,350,250,-100
"724","exp2A-3","sparse_below_average","exp2A-3_sub127",500,"test",248,240,200,-40
"725","exp2A-3","sparse_below_average","exp2A-3_sub128",500,"training",248,5,255,250
"726","exp2A-3","sparse_below_average","exp2A-3_sub128",500,"test",248,255,245,-10
"727","exp2A-3","sparse_below_average","exp2A-3_sub129",500,"training",248,200,250,50
"728","exp2A-3","sparse_below_average","exp2A-3_sub129",500,"test",248,250,200,-50
"729","exp2A-3","sparse_below_average","exp2A-3_sub130",500,"training",248,200,250,50
"730","exp2A-3","sparse_below_average","exp2A-3_sub130",500,"test",248,250,250,0
"731","exp2A-3","sparse_below_average","exp2A-3_sub131",500,"training",248,6,185,179
"732","exp2A-3","sparse_below_average","exp2A-3_sub131",500,"test",248,225,225,0
"733","exp2A-3","sparse_below_average","exp2A-3_sub132",500,"training",248,50,250,200
"734","exp2A-3","sparse_below_average","exp2A-3_sub132",500,"test",248,250,260,10
"735","exp2A-3","sparse_below_average","exp2A-3_sub133",500,"training",248,150,245,95
"736","exp2A-3","sparse_below_average","exp2A-3_sub133",500,"test",248,238,215,-23
"737","exp2A-3","sparse_above_average","exp2A-3_sub134",500,"training",252,5,260,255
"738","exp2A-3","sparse_above_average","exp2A-3_sub134",500,"test",252,255,245,-10
"739","exp2A-3","sparse_above_average","exp2A-3_sub135",500,"training",252,300,224,-76
"740","exp2A-3","sparse_above_average","exp2A-3_sub135",500,"test",252,243,283,40
"741","exp2A-3","sparse_above_average","exp2A-3_sub136",500,"training",252,250,250,0
"742","exp2A-3","sparse_above_average","exp2A-3_sub136",500,"test",252,250,250,0
"743","exp2A-3","sparse_above_average","exp2A-3_sub137",500,"training",252,250,250,0
"744","exp2A-3","sparse_above_average","exp2A-3_sub137",500,"test",252,230,270,40
"745","exp2A-3","sparse_above_average","exp2A-3_sub138",500,"training",252,200,270,70
"746","exp2A-3","sparse_above_average","exp2A-3_sub138",500,"test",252,270,225,-45
"747","exp2A-3","sparse_above_average","exp2A-3_sub139",500,"training",252,100,200,100
"748","exp2A-3","sparse_above_average","exp2A-3_sub139",500,"test",252,250,190,-60
"749","exp2A-3","sparse_above_average","exp2A-3_sub140",500,"training",252,100,150,50
"750","exp2A-3","sparse_above_average","exp2A-3_sub140",500,"test",252,250,200,-50
"751","exp2A-3","sparse_above_average","exp2A-3_sub141",500,"training",252,100,225,125
"752","exp2A-3","sparse_above_average","exp2A-3_sub141",500,"test",252,240,275,35
"753","exp2A-3","sparse_above_average","exp2A-3_sub142",500,"training",252,100,200,100
"754","exp2A-3","sparse_above_average","exp2A-3_sub142",500,"test",252,250,300,50
"755","exp2A-3","sparse_above_average","exp2A-3_sub143",500,"training",252,200,240,40
"756","exp2A-3","sparse_above_average","exp2A-3_sub143",500,"test",252,250,251,1
"757","exp2A-3","sparse_above_average","exp2A-3_sub144",500,"training",252,200,250,50
"758","exp2A-3","sparse_above_average","exp2A-3_sub144",500,"test",252,275,260,-15
"759","exp2A-3","sparse_above_average","exp2A-3_sub145",500,"training",252,100,250,150
"760","exp2A-3","sparse_above_average","exp2A-3_sub145",500,"test",252,250,250,0
"761","exp2A-3","sparse_above_average","exp2A-3_sub146",500,"training",252,250,250,0
"762","exp2A-3","sparse_above_average","exp2A-3_sub146",500,"test",252,250,250,0
"763","exp2A-3","sparse_above_average","exp2A-3_sub147",500,"training",252,250,240,-10
"764","exp2A-3","sparse_above_average","exp2A-3_sub147",500,"test",252,240,250,10
"765","exp2A-3","sparse_above_average","exp2A-3_sub148",500,"training",252,50,220,170
"766","exp2A-3","sparse_above_average","exp2A-3_sub148",500,"test",252,235,230,-5
"767","exp2A-3","sparse_above_average","exp2A-3_sub149",500,"training",252,100,200,100
"768","exp2A-3","sparse_above_average","exp2A-3_sub149",500,"test",252,250,200,-50
"769","exp2A-3","sparse_above_average","exp2A-3_sub150",500,"training",252,50,234,184
"770","exp2A-3","sparse_above_average","exp2A-3_sub150",500,"test",252,250,268,18
"771","exp2A-3","sparse_above_average","exp2A-3_sub151",500,"training",252,100,250,150
"772","exp2A-3","sparse_above_average","exp2A-3_sub151",500,"test",252,240,270,30
"773","exp2A-3","sparse_above_average","exp2A-3_sub152",500,"training",252,200,247,47
"774","exp2A-3","sparse_above_average","exp2A-3_sub152",500,"test",252,235,232,-3
"775","exp2A-3","sparse_above_average","exp2A-3_sub153",500,"training",252,100,200,100
"776","exp2A-3","sparse_above_average","exp2A-3_sub153",500,"test",252,250,250,0
"777","exp2A-3","sparse_above_average","exp2A-3_sub154",500,"training",252,20,240,220
"778","exp2A-3","sparse_above_average","exp2A-3_sub154",500,"test",252,250,250,0
"779","exp2A-3","sparse_above_average","exp2A-3_sub155",500,"training",252,5,215,210
"780","exp2A-3","sparse_above_average","exp2A-3_sub155",500,"test",252,225,225,0
"781","exp2A-3","sparse_above_average","exp2A-3_sub156",500,"training",252,200,247,47
"782","exp2A-3","sparse_above_average","exp2A-3_sub156",500,"test",252,250,265,15
"783","exp2A-3","sparse_above_average","exp2A-3_sub157",500,"training",252,200,200,0
"784","exp2A-3","sparse_above_average","exp2A-3_sub157",500,"test",252,250,250,0
"785","exp2A-3","sparse_above_average","exp2A-3_sub158",500,"training",252,300,260,-40
"786","exp2A-3","sparse_above_average","exp2A-3_sub158",500,"test",252,200,200,0
"787","exp2A-3","sparse_above_average","exp2A-3_sub159",500,"training",252,250,245,-5
"788","exp2A-3","sparse_above_average","exp2A-3_sub159",500,"test",252,245,290,45
"789","exp2A-3","sparse_above_average","exp2A-3_sub160",500,"training",252,100,235,135
"790","exp2A-3","sparse_above_average","exp2A-3_sub160",500,"test",252,260,265,5
"791","exp2A-3","sparse_above_average","exp2A-3_sub161",500,"training",252,240,250,10
"792","exp2A-3","sparse_above_average","exp2A-3_sub161",500,"test",252,270,300,30
"793","exp2A-3","sparse_above_average","exp2A-3_sub162",500,"training",252,200,222,22
"794","exp2A-3","sparse_above_average","exp2A-3_sub162",500,"test",252,242,278,36
"795","exp2A-3","sparse_above_average","exp2A-3_sub163",500,"training",252,1,300,299
"796","exp2A-3","sparse_above_average","exp2A-3_sub163",500,"test",252,250,250,0
"797","exp2A-3","sparse_above_average","exp2A-3_sub164",500,"training",252,100,290,190
"798","exp2A-3","sparse_above_average","exp2A-3_sub164",500,"test",252,250,260,10
"799","exp2A-3","sparse_above_average","exp2A-3_sub165",500,"training",252,20,279,259
"800","exp2A-3","sparse_above_average","exp2A-3_sub165",500,"test",252,265,261,-4
"801","exp2A-3","sparse_above_average","exp2A-3_sub166",500,"training",252,250,275,25
"802","exp2A-3","sparse_above_average","exp2A-3_sub166",500,"test",252,250,250,0
"803","exp2A-3","sparse_above_average","exp2A-3_sub167",500,"training",252,400,225,-175
"804","exp2A-3","sparse_above_average","exp2A-3_sub167",500,"test",252,260,275,15
"805","exp2A-3","sparse_above_average","exp2A-3_sub168",500,"training",252,15,50,35
"806","exp2A-3","sparse_above_average","exp2A-3_sub168",500,"test",252,250,50,-200
"807","exp2A-3","sparse_above_average","exp2A-3_sub169",500,"training",252,250,245,-5
"808","exp2A-3","sparse_above_average","exp2A-3_sub169",500,"test",252,250,250,0
"809","exp2A-3","sparse_above_average","exp2A-3_sub170",500,"training",252,250,250,0
"810","exp2A-3","sparse_above_average","exp2A-3_sub170",500,"test",252,250,200,-50
"811","exp2A-3","sparse_above_average","exp2A-3_sub171",500,"training",252,300,238,-62
"812","exp2A-3","sparse_above_average","exp2A-3_sub171",500,"test",252,238,228,-10
"813","exp2A-3","sparse_above_average","exp2A-3_sub172",500,"training",252,100,240,140
"814","exp2A-3","sparse_above_average","exp2A-3_sub172",500,"test",252,240,305,65
"815","exp2A-3","sparse_above_average","exp2A-3_sub173",500,"training",252,25,235,210
"816","exp2A-3","sparse_above_average","exp2A-3_sub173",500,"test",252,235,210,-25
"817","exp2A-3","sparse_above_average","exp2A-3_sub174",500,"training",252,200,275,75
"818","exp2A-3","sparse_above_average","exp2A-3_sub174",500,"test",252,275,280,5
"819","exp2A-3","sparse_above_average","exp2A-3_sub175",500,"training",252,100,250,150
"820","exp2A-3","sparse_above_average","exp2A-3_sub175",500,"test",252,260,300,40
"821","exp2A-3","sparse_above_average","exp2A-3_sub176",500,"training",252,100,200,100
"822","exp2A-3","sparse_above_average","exp2A-3_sub176",500,"test",252,220,220,0
"823","exp2A-3","sparse_above_average","exp2A-3_sub177",500,"training",252,300,250,-50
"824","exp2A-3","sparse_above_average","exp2A-3_sub177",500,"test",252,250,275,25
"825","exp2A-3","sparse_above_average","exp2A-3_sub178",500,"training",252,150,240,90
"826","exp2A-3","sparse_above_average","exp2A-3_sub178",500,"test",252,240,280,40
"827","exp2A-3","sparse_above_average","exp2A-3_sub179",500,"training",252,250,270,20
"828","exp2A-3","sparse_above_average","exp2A-3_sub179",500,"test",252,270,265,-5
"829","exp2A-3","sparse_above_average","exp2A-3_sub180",500,"training",252,200,225,25
"830","exp2A-3","sparse_above_average","exp2A-3_sub180",500,"test",252,250,250,0
"831","exp2A-3","sparse_above_average","exp2A-3_sub181",500,"training",252,150,240,90
"832","exp2A-3","sparse_above_average","exp2A-3_sub181",500,"test",252,254,250,-4
"833","exp2A-3","sparse_above_average","exp2A-3_sub182",500,"training",252,200,224,24
"834","exp2A-3","sparse_above_average","exp2A-3_sub182",500,"test",252,230,270,40
"835","exp2A-3","sparse_above_average","exp2A-3_sub183",500,"training",252,25,240,215
"836","exp2A-3","sparse_above_average","exp2A-3_sub183",500,"test",252,265,345,80
"837","exp2A-3","sparse_above_average","exp2A-3_sub184",500,"training",252,250,250,0
"838","exp2A-3","sparse_above_average","exp2A-3_sub184",500,"test",252,255,300,45
"839","exp2A-3","sparse_above_average","exp2A-3_sub185",500,"training",252,5,250,245
"840","exp2A-3","sparse_above_average","exp2A-3_sub185",500,"test",252,260,260,0
"841","exp2A-3","sparse_above_average","exp2A-3_sub186",500,"training",252,100,180,80
"842","exp2A-3","sparse_above_average","exp2A-3_sub186",500,"test",252,250,250,0
"843","exp2A-3","sparse_above_average","exp2A-3_sub187",500,"training",252,100,240,140
"844","exp2A-3","sparse_above_average","exp2A-3_sub187",500,"test",252,260,275,15
"845","exp2A-3","sparse_above_average","exp2A-3_sub188",500,"training",252,200,240,40
"846","exp2A-3","sparse_above_average","exp2A-3_sub188",500,"test",252,200,260,60
"847","exp2A-3","sparse_above_average","exp2A-3_sub189",500,"training",252,5,200,195
"848","exp2A-3","sparse_above_average","exp2A-3_sub189",500,"test",252,250,200,-50
"849","exp2A-3","sparse_above_average","exp2A-3_sub190",500,"training",252,100,250,150
"850","exp2A-3","sparse_above_average","exp2A-3_sub190",500,"test",252,250,250,0
"851","exp2A-3","sparse_above_average","exp2A-3_sub191",500,"training",252,300,265,-35
"852","exp2A-3","sparse_above_average","exp2A-3_sub191",500,"test",252,248,235,-13
"853","exp2A-3","sparse_above_average","exp2A-3_sub192",500,"training",252,350,250,-100
"854","exp2A-3","sparse_above_average","exp2A-3_sub192",500,"test",252,240,205,-35
"855","exp2A-3","sparse_above_average","exp2A-3_sub193",500,"training",252,4,350,346
"856","exp2A-3","sparse_above_average","exp2A-3_sub193",500,"test",252,250,250,0
"857","exp2A-3","sparse_above_average","exp2A-3_sub194",500,"training",252,100,230,130
"858","exp2A-3","sparse_above_average","exp2A-3_sub194",500,"test",252,230,270,40
"859","exp2A-3","sparse_above_average","exp2A-3_sub195",500,"training",252,100,225,125
"860","exp2A-3","sparse_above_average","exp2A-3_sub195",500,"test",252,230,225,-5
"861","exp2A-3","sparse_above_average","exp2A-3_sub196",500,"training",252,200,250,50
"862","exp2A-3","sparse_above_average","exp2A-3_sub196",500,"test",252,250,280,30
"863","exp2A-3","sparse_above_average","exp2A-3_sub197",500,"training",252,200,250,50
"864","exp2A-3","sparse_above_average","exp2A-3_sub197",500,"test",252,250,275,25
"865","exp2A-3","sparse_above_average","exp2A-3_sub198",500,"training",252,250,240,-10
"866","exp2A-3","sparse_above_average","exp2A-3_sub198",500,"test",252,250,275,25
"867","exp2A-3","sparse_above_average","exp2A-3_sub199",500,"training",252,100,150,50
"868","exp2A-3","sparse_above_average","exp2A-3_sub199",500,"test",252,245,268,23
"869","exp2A-3","sparse_above_average","exp2A-3_sub200",500,"training",252,200,200,0
"870","exp2A-3","sparse_above_average","exp2A-3_sub200",500,"test",252,300,200,-100
"871","exp2A-3","sparse_above_average","exp2A-3_sub201",500,"training",252,100,244,144
"872","exp2A-3","sparse_above_average","exp2A-3_sub201",500,"test",252,246,288,42
"873","exp2A-3","sparse_above_average","exp2A-3_sub202",500,"training",252,3,250,247
"874","exp2A-3","sparse_above_average","exp2A-3_sub202",500,"test",252,250,240,-10
"875","exp2A-3","sparse_above_average","exp2A-3_sub203",500,"training",252,200,221,21
"876","exp2A-3","sparse_above_average","exp2A-3_sub203",500,"test",252,240,280,40
"877","exp2A-3","sparse_above_average","exp2A-3_sub204",500,"training",252,200,225,25
"878","exp2A-3","sparse_above_average","exp2A-3_sub204",500,"test",252,240,305,65
"879","exp2A-3","sparse_above_average","exp2A-3_sub205",500,"training",252,250,250,0
"880","exp2A-3","sparse_above_average","exp2A-3_sub205",500,"test",252,240,200,-40
"881","exp2A-3","sparse_above_average","exp2A-3_sub206",500,"training",252,100,230,130
"882","exp2A-3","sparse_above_average","exp2A-3_sub206",500,"test",252,240,234,-6
"883","exp2A-3","sparse_above_average","exp2A-3_sub207",500,"training",252,300,240,-60
"884","exp2A-3","sparse_above_average","exp2A-3_sub207",500,"test",252,270,275,5
"885","exp2A-3","sparse_above_average","exp2A-3_sub208",500,"training",252,250,275,25
"886","exp2A-3","sparse_above_average","exp2A-3_sub208",500,"test",252,245,256,11
"887","exp2A-3","sparse_above_average","exp2A-3_sub209",500,"training",252,250,40,-210
"888","exp2A-3","sparse_above_average","exp2A-3_sub209",500,"test",252,250,50,-200
"889","exp2A-3","sparse_above_average","exp2A-3_sub210",500,"training",252,300,175,-125
"890","exp2A-3","sparse_above_average","exp2A-3_sub210",500,"test",252,255,250,-5
"891","exp2A-3","sparse_above_average","exp2A-3_sub211",500,"training",252,200,220,20
"892","exp2A-3","sparse_above_average","exp2A-3_sub211",500,"test",252,265,264,-1
"893","exp2A-3","sparse_above_average","exp2A-3_sub212",500,"training",252,150,247,97
"894","exp2A-3","sparse_above_average","exp2A-3_sub212",500,"test",252,250,280,30
"895","exp2A-3","sparse_above_average","exp2A-3_sub213",500,"training",252,300,250,-50
"896","exp2A-3","sparse_above_average","exp2A-3_sub213",500,"test",252,250,250,0
"897","exp2A-3","sparse_above_average","exp2A-3_sub214",500,"training",252,250,250,0
"898","exp2A-3","sparse_above_average","exp2A-3_sub214",500,"test",252,265,268,3
"899","exp2A-3","sparse_above_average","exp2A-3_sub215",500,"training",252,200,245,45
"900","exp2A-3","sparse_above_average","exp2A-3_sub215",500,"test",252,250,290,40
"901","exp2A-3","sparse_above_average","exp2A-3_sub216",500,"training",252,50,279,229
"902","exp2A-3","sparse_above_average","exp2A-3_sub216",500,"test",252,260,250,-10
"903","exp2A-3","sparse_above_average","exp2A-3_sub217",500,"training",252,200,235,35
"904","exp2A-3","sparse_above_average","exp2A-3_sub217",500,"test",252,255,260,5
"905","exp2A-3","sparse_above_average","exp2A-3_sub218",500,"training",252,125,247,122
"906","exp2A-3","sparse_above_average","exp2A-3_sub218",500,"test",252,230,270,40
"907","exp2A-3","sparse_above_average","exp2A-3_sub219",500,"training",252,100,250,150
"908","exp2A-3","sparse_above_average","exp2A-3_sub219",500,"test",252,250,300,50
"909","exp2A-3","sparse_above_average","exp2A-3_sub220",500,"training",252,200,250,50
"910","exp2A-3","sparse_above_average","exp2A-3_sub220",500,"test",252,255,300,45
"911","exp2A-3","sparse_above_average","exp2A-3_sub221",500,"training",252,250,230,-20
"912","exp2A-3","sparse_above_average","exp2A-3_sub221",500,"test",252,240,240,0
"913","exp2A-3","sparse_above_average","exp2A-3_sub222",500,"training",252,250,240,-10
"914","exp2A-3","sparse_above_average","exp2A-3_sub222",500,"test",252,250,250,0
"915","exp2A-3","sparse_above_average","exp2A-3_sub223",500,"training",252,150,240,90
"916","exp2A-3","sparse_above_average","exp2A-3_sub223",500,"test",252,260,260,0
"917","exp2A-3","sparse_above_average","exp2A-3_sub224",500,"training",252,250,250,0
"918","exp2A-3","sparse_above_average","exp2A-3_sub224",500,"test",252,255,300,45
"919","exp2A-3","sparse_above_average","exp2A-3_sub225",500,"training",252,100,230,130
"920","exp2A-3","sparse_above_average","exp2A-3_sub225",500,"test",252,250,244,-6
"921","exp2A-3","sparse_above_average","exp2A-3_sub226",500,"training",252,50,220,170
"922","exp2A-3","sparse_above_average","exp2A-3_sub226",500,"test",252,220,250,30
"923","exp2A-3","sparse_above_average","exp2A-3_sub227",500,"training",252,200,200,0
"924","exp2A-3","sparse_above_average","exp2A-3_sub227",500,"test",252,250,235,-15
"925","exp2A-3","sparse_above_average","exp2A-3_sub228",500,"training",252,300,175,-125
"926","exp2A-3","sparse_above_average","exp2A-3_sub228",500,"test",252,248,210,-38
"927","exp2A-3","sparse_above_average","exp2A-3_sub229",500,"training",252,250,245,-5
"928","exp2A-3","sparse_above_average","exp2A-3_sub229",500,"test",252,245,280,35
"929","exp2A-3","sparse_above_average","exp2A-3_sub230",500,"training",252,300,280,-20
"930","exp2A-3","sparse_above_average","exp2A-3_sub230",500,"test",252,250,250,0
"931","exp2A-3","sparse_above_average","exp2A-3_sub231",500,"training",252,100,245,145
"932","exp2A-3","sparse_above_average","exp2A-3_sub231",500,"test",252,250,280,30
"933","exp2A-3","sparse_above_average","exp2A-3_sub232",500,"training",252,150,228,78
"934","exp2A-3","sparse_above_average","exp2A-3_sub232",500,"test",252,288,321,33
"935","exp2A-3","sparse_above_average","exp2A-3_sub233",500,"training",252,100,263,163
"936","exp2A-3","sparse_above_average","exp2A-3_sub233",500,"test",252,263,303,40
"937","exp2A-3","sparse_above_average","exp2A-3_sub234",500,"training",252,10,375,365
"938","exp2A-3","sparse_above_average","exp2A-3_sub234",500,"test",252,275,298,23
"939","exp2A-3","sparse_above_average","exp2A-3_sub235",500,"training",252,100,220,120
"940","exp2A-3","sparse_above_average","exp2A-3_sub235",500,"test",252,230,215,-15
"941","exp2A-3","sparse_above_average","exp2A-3_sub236",500,"training",252,100,250,150
"942","exp2A-3","sparse_above_average","exp2A-3_sub236",500,"test",252,250,275,25
"943","exp2A-3","sparse_above_average","exp2A-3_sub237",500,"training",252,100,250,150
"944","exp2A-3","sparse_above_average","exp2A-3_sub237",500,"test",252,250,300,50
"945","exp2A-3","sparse_above_average","exp2A-3_sub238",500,"training",252,200,200,0
"946","exp2A-3","sparse_above_average","exp2A-3_sub238",500,"test",252,230,250,20
"947","exp2A-3","sparse_above_average","exp2A-3_sub239",500,"training",252,250,250,0
"948","exp2A-3","sparse_above_average","exp2A-3_sub239",500,"test",252,250,260,10
"949","exp2A-3","sparse_above_average","exp2A-3_sub240",500,"training",252,200,200,0
"950","exp2A-3","sparse_above_average","exp2A-3_sub240",500,"test",252,237,300,63
"951","exp2A-3","sparse_above_average","exp2A-3_sub241",500,"training",252,200,240,40
"952","exp2A-3","sparse_above_average","exp2A-3_sub241",500,"test",252,240,270,30
"953","exp2A-3","sparse_above_average","exp2A-3_sub242",500,"training",252,300,230,-70
"954","exp2A-3","sparse_above_average","exp2A-3_sub242",500,"test",252,240,235,-5
"955","exp2A-3","sparse_above_average","exp2A-3_sub243",500,"training",252,100,250,150
"956","exp2A-3","sparse_above_average","exp2A-3_sub243",500,"test",252,250,270,20
"957","exp2A-3","sparse_above_average","exp2A-3_sub244",500,"training",252,180,257,77
"958","exp2A-3","sparse_above_average","exp2A-3_sub244",500,"test",252,241,244,3
"959","exp2A-3","sparse_above_average","exp2A-3_sub245",500,"training",252,50,250,200
"960","exp2A-3","sparse_above_average","exp2A-3_sub245",500,"test",252,260,300,40
"961","exp2A-3","sparse_above_average","exp2A-3_sub246",500,"training",252,100,245,145
"962","exp2A-3","sparse_above_average","exp2A-3_sub246",500,"test",252,245,250,5
"963","exp2A-3","sparse_above_average","exp2A-3_sub247",500,"training",252,2,230,228
"964","exp2A-3","sparse_above_average","exp2A-3_sub247",500,"test",252,240,260,20
"965","exp2A-3","sparse_above_average","exp2A-3_sub248",500,"training",252,60,180,120
"966","exp2A-3","sparse_above_average","exp2A-3_sub248",500,"test",252,250,240,-10
"967","exp2A-3","sparse_above_average","exp2A-3_sub249",500,"training",252,200,260,60
"968","exp2A-3","sparse_above_average","exp2A-3_sub249",500,"test",252,260,250,-10
"969","exp2A-3","sparse_above_average","exp2A-3_sub250",500,"training",252,200,250,50
"970","exp2A-3","sparse_above_average","exp2A-3_sub250",500,"test",252,250,250,0
"971","exp2A-3","sparse_above_average","exp2A-3_sub251",500,"training",252,250,245,-5
"972","exp2A-3","sparse_above_average","exp2A-3_sub251",500,"test",252,245,280,35
"973","exp2A-3","sparse_above_average","exp2A-3_sub252",500,"training",252,200,220,20
"974","exp2A-3","sparse_above_average","exp2A-3_sub252",500,"test",252,245,260,15
"975","exp2A-3","sparse_above_average","exp2A-3_sub253",500,"training",252,100,200,100
"976","exp2A-3","sparse_above_average","exp2A-3_sub253",500,"test",252,250,250,0
"977","exp2A-3","sparse_above_average","exp2A-3_sub254",500,"training",252,2,175,173
"978","exp2A-3","sparse_above_average","exp2A-3_sub254",500,"test",252,254,242,-12
"979","exp2A-3","sparse_above_average","exp2A-3_sub255",500,"training",252,200,220,20
"980","exp2A-3","sparse_above_average","exp2A-3_sub255",500,"test",252,230,230,0
"981","exp2A-3","sparse_above_average","exp2A-3_sub256",500,"training",252,100,250,150
"982","exp2A-3","sparse_above_average","exp2A-3_sub256",500,"test",252,250,250,0
"983","exp2A-3","sparse_above_average","exp2A-3_sub257",500,"training",252,100,230,130
"984","exp2A-3","sparse_above_average","exp2A-3_sub257",500,"test",252,250,260,10
"985","exp2A-3","sparse_above_average","exp2A-3_sub258",500,"training",252,100,225,125
"986","exp2A-3","sparse_above_average","exp2A-3_sub258",500,"test",252,250,250,0
"987","exp2A-3","sparse_above_average","exp2A-3_sub259",500,"training",252,200,260,60
"988","exp2A-3","sparse_above_average","exp2A-3_sub259",500,"test",252,260,255,-5
"989","exp2A-3","sparse_above_average","exp2A-3_sub260",500,"training",252,200,250,50
"990","exp2A-3","sparse_above_average","exp2A-3_sub260",500,"test",252,250,275,25
"991","expA-4","sparse_below_average","expA-4_sub001",500,"training",248,5,285,280
"992","expA-4","sparse_below_average","expA-4_sub001",500,"test",248,250,165,-85
"993","expA-4","sparse_below_average","expA-4_sub002",500,"training",248,300,220,-80
"994","expA-4","sparse_below_average","expA-4_sub002",500,"test",248,230,230,0
"995","expA-4","sparse_below_average","expA-4_sub003",500,"training",248,200,230,30
"996","expA-4","sparse_below_average","expA-4_sub003",500,"test",248,230,200,-30
"997","expA-4","sparse_below_average","expA-4_sub004",500,"training",248,200,230,30
"998","expA-4","sparse_below_average","expA-4_sub004",500,"test",248,230,200,-30
"999","expA-4","sparse_below_average","expA-4_sub005",500,"training",248,15,225,210
"1000","expA-4","sparse_below_average","expA-4_sub005",500,"test",248,220,274,54
"1001","expA-4","sparse_below_average","expA-4_sub006",500,"training",248,20,300,280
"1002","expA-4","sparse_below_average","expA-4_sub006",500,"test",248,230,210,-20
"1003","expA-4","sparse_below_average","expA-4_sub007",500,"training",248,100,250,150
"1004","expA-4","sparse_below_average","expA-4_sub007",500,"test",248,250,275,25
"1005","expA-4","sparse_below_average","expA-4_sub008",500,"training",248,100,240,140
"1006","expA-4","sparse_below_average","expA-4_sub008",500,"test",248,240,260,20
"1007","expA-4","sparse_below_average","expA-4_sub009",500,"training",248,300,300,0
"1008","expA-4","sparse_below_average","expA-4_sub009",500,"test",248,250,250,0
"1009","expA-4","sparse_below_average","expA-4_sub010",500,"training",248,200,250,50
"1010","expA-4","sparse_below_average","expA-4_sub010",500,"test",248,250,250,0
"1011","expA-4","sparse_below_average","expA-4_sub011",500,"training",248,250,150,-100
"1012","expA-4","sparse_below_average","expA-4_sub011",500,"test",248,250,250,0
"1013","expA-4","sparse_below_average","expA-4_sub012",500,"training",248,5,220,215
"1014","expA-4","sparse_below_average","expA-4_sub012",500,"test",248,220,200,-20
"1015","expA-4","sparse_below_average","expA-4_sub013",500,"training",248,100,225,125
"1016","expA-4","sparse_below_average","expA-4_sub013",500,"test",248,240,225,-15
"1017","expA-4","sparse_below_average","expA-4_sub014",500,"training",248,200,250,50
"1018","expA-4","sparse_below_average","expA-4_sub014",500,"test",248,250,265,15
"1019","expA-4","sparse_below_average","expA-4_sub015",500,"training",248,100,350,250
"1020","expA-4","sparse_below_average","expA-4_sub015",500,"test",248,230,225,-5
"1021","expA-4","sparse_below_average","expA-4_sub016",500,"training",248,200,230,30
"1022","expA-4","sparse_below_average","expA-4_sub016",500,"test",248,235,246,11
"1023","expA-4","sparse_below_average","expA-4_sub017",500,"training",248,200,305,105
"1024","expA-4","sparse_below_average","expA-4_sub017",500,"test",248,250,320,70
"1025","expA-4","sparse_below_average","expA-4_sub018",500,"training",248,250,245,-5
"1026","expA-4","sparse_below_average","expA-4_sub018",500,"test",248,250,265,15
"1027","expA-4","sparse_below_average","expA-4_sub019",500,"training",248,100,220,120
"1028","expA-4","sparse_below_average","expA-4_sub019",500,"test",248,230,200,-30
"1029","expA-4","sparse_below_average","expA-4_sub020",500,"training",248,250,230,-20
"1030","expA-4","sparse_below_average","expA-4_sub020",500,"test",248,240,210,-30
"1031","expA-4","sparse_below_average","expA-4_sub021",500,"training",248,150,250,100
"1032","expA-4","sparse_below_average","expA-4_sub021",500,"test",248,250,225,-25
"1033","expA-4","sparse_below_average","expA-4_sub022",500,"training",248,200,250,50
"1034","expA-4","sparse_below_average","expA-4_sub022",500,"test",248,250,250,0
"1035","expA-4","sparse_below_average","expA-4_sub023",500,"training",248,250,200,-50
"1036","expA-4","sparse_below_average","expA-4_sub023",500,"test",248,250,250,0
"1037","expA-4","sparse_below_average","expA-4_sub024",500,"training",248,200,245,45
"1038","expA-4","sparse_below_average","expA-4_sub024",500,"test",248,250,250,0
"1039","expA-4","sparse_below_average","expA-4_sub025",500,"training",248,100,230,130
"1040","expA-4","sparse_below_average","expA-4_sub025",500,"test",248,230,270,40
"1041","expA-4","sparse_below_average","expA-4_sub026",500,"training",248,100,250,150
"1042","expA-4","sparse_below_average","expA-4_sub026",500,"test",248,225,250,25
"1043","expA-4","sparse_below_average","expA-4_sub027",500,"training",248,20,140,120
"1044","expA-4","sparse_below_average","expA-4_sub027",500,"test",248,240,220,-20
"1045","expA-4","sparse_below_average","expA-4_sub028",500,"training",248,100,300,200
"1046","expA-4","sparse_below_average","expA-4_sub028",500,"test",248,240,230,-10
"1047","expA-4","sparse_below_average","expA-4_sub029",500,"training",248,200,250,50
"1048","expA-4","sparse_below_average","expA-4_sub029",500,"test",248,275,222,-53
"1049","expA-4","sparse_below_average","expA-4_sub030",500,"training",248,200,200,0
"1050","expA-4","sparse_below_average","expA-4_sub030",500,"test",248,200,200,0
"1051","expA-4","sparse_below_average","expA-4_sub031",500,"training",248,200,230,30
"1052","expA-4","sparse_below_average","expA-4_sub031",500,"test",248,235,180,-55
"1053","expA-4","sparse_below_average","expA-4_sub032",500,"training",248,200,250,50
"1054","expA-4","sparse_below_average","expA-4_sub032",500,"test",248,250,270,20
"1055","expA-4","sparse_below_average","expA-4_sub033",500,"training",248,100,250,150
"1056","expA-4","sparse_below_average","expA-4_sub033",500,"test",248,255,255,0
"1057","expA-4","sparse_below_average","expA-4_sub034",500,"training",248,200,245,45
"1058","expA-4","sparse_below_average","expA-4_sub034",500,"test",248,245,215,-30
"1059","expA-4","sparse_below_average","expA-4_sub035",500,"training",248,50,220,170
"1060","expA-4","sparse_below_average","expA-4_sub035",500,"test",248,200,230,30
"1061","expA-4","sparse_below_average","expA-4_sub036",500,"training",248,255,250,-5
"1062","expA-4","sparse_below_average","expA-4_sub036",500,"test",248,255,245,-10
"1063","expA-4","sparse_below_average","expA-4_sub037",500,"training",248,150,230,80
"1064","expA-4","sparse_below_average","expA-4_sub037",500,"test",248,235,245,10
"1065","expA-4","sparse_below_average","expA-4_sub038",500,"training",248,300,250,-50
"1066","expA-4","sparse_below_average","expA-4_sub038",500,"test",248,260,250,-10
"1067","expA-4","sparse_below_average","expA-4_sub039",500,"training",248,100,250,150
"1068","expA-4","sparse_below_average","expA-4_sub039",500,"test",248,250,220,-30
"1069","expA-4","sparse_below_average","expA-4_sub040",500,"training",248,100,240,140
"1070","expA-4","sparse_below_average","expA-4_sub040",500,"test",248,240,280,40
"1071","expA-4","sparse_below_average","expA-4_sub041",500,"training",248,250,243,-7
"1072","expA-4","sparse_below_average","expA-4_sub041",500,"test",248,240,254,14
"1073","expA-4","sparse_below_average","expA-4_sub042",500,"training",248,200,250,50
"1074","expA-4","sparse_below_average","expA-4_sub042",500,"test",248,250,250,0
"1075","expA-4","sparse_below_average","expA-4_sub043",500,"training",248,200,260,60
"1076","expA-4","sparse_below_average","expA-4_sub043",500,"test",248,265,245,-20
"1077","expA-4","sparse_below_average","expA-4_sub044",500,"training",248,200,230,30
"1078","expA-4","sparse_below_average","expA-4_sub044",500,"test",248,235,200,-35
"1079","expA-4","sparse_below_average","expA-4_sub045",500,"training",248,250,235,-15
"1080","expA-4","sparse_below_average","expA-4_sub045",500,"test",248,250,240,-10
"1081","expA-4","sparse_below_average","expA-4_sub046",500,"training",248,40,230,190
"1082","expA-4","sparse_below_average","expA-4_sub046",500,"test",248,240,200,-40
"1083","expA-4","sparse_below_average","expA-4_sub047",500,"training",248,299,235,-64
"1084","expA-4","sparse_below_average","expA-4_sub047",500,"test",248,250,225,-25
"1085","expA-4","sparse_below_average","expA-4_sub048",500,"training",248,4,345,341
"1086","expA-4","sparse_below_average","expA-4_sub048",500,"test",248,235,320,85
"1087","expA-4","sparse_below_average","expA-4_sub049",500,"training",248,200,220,20
"1088","expA-4","sparse_below_average","expA-4_sub049",500,"test",248,230,250,20
"1089","expA-4","sparse_below_average","expA-4_sub050",500,"training",248,200,244,44
"1090","expA-4","sparse_below_average","expA-4_sub050",500,"test",248,255,244,-11
"1091","expA-4","sparse_below_average","expA-4_sub051",500,"training",248,200,250,50
"1092","expA-4","sparse_below_average","expA-4_sub051",500,"test",248,250,270,20
"1093","expA-4","sparse_below_average","expA-4_sub052",500,"training",248,200,220,20
"1094","expA-4","sparse_below_average","expA-4_sub052",500,"test",248,235,250,15
"1095","expA-4","sparse_below_average","expA-4_sub053",500,"training",248,150,250,100
"1096","expA-4","sparse_below_average","expA-4_sub053",500,"test",248,250,260,10
"1097","expA-4","sparse_below_average","expA-4_sub054",500,"training",248,250,230,-20
"1098","expA-4","sparse_below_average","expA-4_sub054",500,"test",248,240,240,0
"1099","expA-4","sparse_below_average","expA-4_sub055",500,"training",248,300,230,-70
"1100","expA-4","sparse_below_average","expA-4_sub055",500,"test",248,250,245,-5
"1101","expA-4","sparse_below_average","expA-4_sub056",500,"training",248,200,250,50
"1102","expA-4","sparse_below_average","expA-4_sub056",500,"test",248,250,225,-25
"1103","expA-4","sparse_below_average","expA-4_sub057",500,"training",248,50,230,180
"1104","expA-4","sparse_below_average","expA-4_sub057",500,"test",248,250,200,-50
"1105","expA-4","sparse_below_average","expA-4_sub058",500,"training",248,200,255,55
"1106","expA-4","sparse_below_average","expA-4_sub058",500,"test",248,255,230,-25
"1107","expA-4","sparse_below_average","expA-4_sub059",500,"training",248,200,250,50
"1108","expA-4","sparse_below_average","expA-4_sub059",500,"test",248,250,210,-40
"1109","expA-4","sparse_below_average","expA-4_sub060",500,"training",248,200,225,25
"1110","expA-4","sparse_below_average","expA-4_sub060",500,"test",248,250,250,0
"1111","expA-4","sparse_below_average","expA-4_sub061",500,"training",248,5,240,235
"1112","expA-4","sparse_below_average","expA-4_sub061",500,"test",248,240,280,40
"1113","expA-4","sparse_below_average","expA-4_sub062",500,"training",248,100,250,150
"1114","expA-4","sparse_below_average","expA-4_sub062",500,"test",248,250,250,0
"1115","expA-4","sparse_below_average","expA-4_sub063",500,"training",248,200,250,50
"1116","expA-4","sparse_below_average","expA-4_sub063",500,"test",248,255,280,25
"1117","expA-4","sparse_below_average","expA-4_sub064",500,"training",248,200,215,15
"1118","expA-4","sparse_below_average","expA-4_sub064",500,"test",248,230,234,4
"1119","expA-4","sparse_below_average","expA-4_sub065",500,"training",248,250,247,-3
"1120","expA-4","sparse_below_average","expA-4_sub065",500,"test",248,240,221,-19
"1121","expA-4","sparse_below_average","expA-4_sub066",500,"training",248,500,225,-275
"1122","expA-4","sparse_below_average","expA-4_sub066",500,"test",248,220,250,30
"1123","expA-4","sparse_below_average","expA-4_sub067",500,"training",248,100,225,125
"1124","expA-4","sparse_below_average","expA-4_sub067",500,"test",248,230,225,-5
"1125","expA-4","sparse_below_average","expA-4_sub068",500,"training",248,100,150,50
"1126","expA-4","sparse_below_average","expA-4_sub068",500,"test",248,250,200,-50
"1127","expA-4","sparse_below_average","expA-4_sub069",500,"training",248,200,250,50
"1128","expA-4","sparse_below_average","expA-4_sub069",500,"test",248,250,255,5
"1129","expA-4","sparse_below_average","expA-4_sub070",500,"training",248,200,230,30
"1130","expA-4","sparse_below_average","expA-4_sub070",500,"test",248,230,240,10
"1131","expA-4","sparse_below_average","expA-4_sub071",500,"training",248,200,240,40
"1132","expA-4","sparse_below_average","expA-4_sub071",500,"test",248,240,220,-20
"1133","expA-4","sparse_below_average","expA-4_sub072",500,"training",248,250,255,5
"1134","expA-4","sparse_below_average","expA-4_sub072",500,"test",248,258,258,0
"1135","expA-4","sparse_below_average","expA-4_sub073",500,"training",248,300,235,-65
"1136","expA-4","sparse_below_average","expA-4_sub073",500,"test",248,240,240,0
"1137","expA-4","sparse_below_average","expA-4_sub074",500,"training",248,250,250,0
"1138","expA-4","sparse_below_average","expA-4_sub074",500,"test",248,250,200,-50
"1139","expA-4","sparse_below_average","expA-4_sub075",500,"training",248,2,200,198
"1140","expA-4","sparse_below_average","expA-4_sub075",500,"test",248,200,275,75
"1141","expA-4","sparse_below_average","expA-4_sub076",500,"training",248,3,250,247
"1142","expA-4","sparse_below_average","expA-4_sub076",500,"test",248,250,325,75
"1143","expA-4","sparse_below_average","expA-4_sub077",500,"training",248,50,250,200
"1144","expA-4","sparse_below_average","expA-4_sub077",500,"test",248,250,265,15
"1145","expA-4","sparse_below_average","expA-4_sub078",500,"training",248,250,240,-10
"1146","expA-4","sparse_below_average","expA-4_sub078",500,"test",248,250,275,25
"1147","expA-4","sparse_below_average","expA-4_sub079",500,"training",248,250,254,4
"1148","expA-4","sparse_below_average","expA-4_sub079",500,"test",248,246,223,-23
"1149","expA-4","sparse_below_average","expA-4_sub080",500,"training",248,20,200,180
"1150","expA-4","sparse_below_average","expA-4_sub080",500,"test",248,250,250,0
"1151","expA-4","sparse_below_average","expA-4_sub081",500,"training",248,150,250,100
"1152","expA-4","sparse_below_average","expA-4_sub081",500,"test",248,250,276,26
"1153","expA-4","sparse_below_average","expA-4_sub082",500,"training",248,100,215,115
"1154","expA-4","sparse_below_average","expA-4_sub082",500,"test",248,235,268,33
"1155","expA-4","sparse_below_average","expA-4_sub083",500,"training",248,200,240,40
"1156","expA-4","sparse_below_average","expA-4_sub083",500,"test",248,250,186,-64
"1157","expA-4","sparse_below_average","expA-4_sub084",500,"training",248,250,250,0
"1158","expA-4","sparse_below_average","expA-4_sub084",500,"test",248,250,220,-30
"1159","expA-4","sparse_below_average","expA-4_sub085",500,"training",248,3,250,247
"1160","expA-4","sparse_below_average","expA-4_sub085",500,"test",248,250,200,-50
"1161","expA-4","sparse_below_average","expA-4_sub086",500,"training",248,50,225,175
"1162","expA-4","sparse_below_average","expA-4_sub086",500,"test",248,230,225,-5
"1163","expA-4","sparse_below_average","expA-4_sub087",500,"training",248,100,225,125
"1164","expA-4","sparse_below_average","expA-4_sub087",500,"test",248,225,260,35
"1165","expA-4","sparse_below_average","expA-4_sub088",500,"training",248,40,250,210
"1166","expA-4","sparse_below_average","expA-4_sub088",500,"test",248,230,320,90
"1167","expA-4","sparse_below_average","expA-4_sub089",500,"training",248,50,230,180
"1168","expA-4","sparse_below_average","expA-4_sub089",500,"test",248,250,200,-50
"1169","expA-4","sparse_below_average","expA-4_sub090",500,"training",248,300,270,-30
"1170","expA-4","sparse_below_average","expA-4_sub090",500,"test",248,275,250,-25
"1171","expA-4","sparse_below_average","expA-4_sub091",500,"training",248,199,250,51
"1172","expA-4","sparse_below_average","expA-4_sub091",500,"test",248,250,215,-35
"1173","expA-4","sparse_below_average","expA-4_sub092",500,"training",248,200,260,60
"1174","expA-4","sparse_below_average","expA-4_sub092",500,"test",248,260,275,15
"1175","expA-4","sparse_below_average","expA-4_sub093",500,"training",248,250,240,-10
"1176","expA-4","sparse_below_average","expA-4_sub093",500,"test",248,240,260,20
"1177","expA-4","sparse_below_average","expA-4_sub094",500,"training",248,50,225,175
"1178","expA-4","sparse_below_average","expA-4_sub094",500,"test",248,225,225,0
"1179","expA-4","sparse_below_average","expA-4_sub095",500,"training",248,150,295,145
"1180","expA-4","sparse_below_average","expA-4_sub095",500,"test",248,230,320,90
"1181","expA-4","sparse_below_average","expA-4_sub096",500,"training",248,50,250,200
"1182","expA-4","sparse_below_average","expA-4_sub096",500,"test",248,250,250,0
"1183","expA-4","sparse_below_average","expA-4_sub097",500,"training",248,5,230,225
"1184","expA-4","sparse_below_average","expA-4_sub097",500,"test",248,220,210,-10
"1185","expA-4","sparse_below_average","expA-4_sub098",500,"training",248,50,45,-5
"1186","expA-4","sparse_below_average","expA-4_sub098",500,"test",248,260,50,-210
"1187","expA-4","sparse_below_average","expA-4_sub099",500,"training",248,200,250,50
"1188","expA-4","sparse_below_average","expA-4_sub099",500,"test",248,250,200,-50
"1189","expA-4","sparse_below_average","expA-4_sub100",500,"training",248,5,250,245
"1190","expA-4","sparse_below_average","expA-4_sub100",500,"test",248,250,200,-50
"1191","expA-4","sparse_below_average","expA-4_sub101",500,"training",248,200,200,0
"1192","expA-4","sparse_below_average","expA-4_sub101",500,"test",248,250,250,0
"1193","expA-4","sparse_below_average","expA-4_sub102",500,"training",248,300,255,-45
"1194","expA-4","sparse_below_average","expA-4_sub102",500,"test",248,250,210,-40
"1195","expA-4","sparse_below_average","expA-4_sub103",500,"training",248,100,240,140
"1196","expA-4","sparse_below_average","expA-4_sub103",500,"test",248,250,250,0
"1197","expA-4","sparse_below_average","expA-4_sub104",500,"training",248,300,240,-60
"1198","expA-4","sparse_below_average","expA-4_sub104",500,"test",248,230,210,-20
"1199","expA-4","sparse_below_average","expA-4_sub105",500,"training",248,100,250,150
"1200","expA-4","sparse_below_average","expA-4_sub105",500,"test",248,230,240,10
"1201","expA-4","sparse_below_average","expA-4_sub106",500,"training",248,200,250,50
"1202","expA-4","sparse_below_average","expA-4_sub106",500,"test",248,250,200,-50
"1203","expA-4","sparse_below_average","expA-4_sub107",500,"training",248,250,240,-10
"1204","expA-4","sparse_below_average","expA-4_sub107",500,"test",248,235,238,3
"1205","expA-4","sparse_below_average","expA-4_sub108",500,"training",248,250,246,-4
"1206","expA-4","sparse_below_average","expA-4_sub108",500,"test",248,245,252,7
"1207","expA-4","sparse_below_average","expA-4_sub109",500,"training",248,200,240,40
"1208","expA-4","sparse_below_average","expA-4_sub109",500,"test",248,200,290,90
"1209","expA-4","sparse_below_average","expA-4_sub110",500,"training",248,50,250,200
"1210","expA-4","sparse_below_average","expA-4_sub110",500,"test",248,250,250,0
"1211","expA-4","sparse_below_average","expA-4_sub111",500,"training",248,120,235,115
"1212","expA-4","sparse_below_average","expA-4_sub111",500,"test",248,245,285,40
"1213","expA-4","sparse_below_average","expA-4_sub112",500,"training",248,3,220,217
"1214","expA-4","sparse_below_average","expA-4_sub112",500,"test",248,240,270,30
"1215","expA-4","sparse_below_average","expA-4_sub113",500,"training",248,50,232,182
"1216","expA-4","sparse_below_average","expA-4_sub113",500,"test",248,225,250,25
"1217","expA-4","sparse_below_average","expA-4_sub114",500,"training",248,100,250,150
"1218","expA-4","sparse_below_average","expA-4_sub114",500,"test",248,250,250,0
"1219","expA-4","sparse_below_average","expA-4_sub115",500,"training",248,20,240,220
"1220","expA-4","sparse_below_average","expA-4_sub115",500,"test",248,240,300,60
"1221","expA-4","sparse_below_average","expA-4_sub116",500,"training",248,50,150,100
"1222","expA-4","sparse_below_average","expA-4_sub116",500,"test",248,250,200,-50
"1223","expA-4","sparse_below_average","expA-4_sub117",500,"training",248,5,240,235
"1224","expA-4","sparse_below_average","expA-4_sub117",500,"test",248,240,223,-17
"1225","expA-4","sparse_below_average","expA-4_sub118",500,"training",248,250,245,-5
"1226","expA-4","sparse_below_average","expA-4_sub118",500,"test",248,250,250,0
"1227","expA-4","sparse_above_average","expA-4_sub119",500,"training",252,300,235,-65
"1228","expA-4","sparse_above_average","expA-4_sub119",500,"test",252,250,265,15
"1229","expA-4","sparse_above_average","expA-4_sub120",500,"training",252,150,225,75
"1230","expA-4","sparse_above_average","expA-4_sub120",500,"test",252,235,288,53
"1231","expA-4","sparse_above_average","expA-4_sub121",500,"training",252,200,250,50
"1232","expA-4","sparse_above_average","expA-4_sub121",500,"test",252,270,260,-10
"1233","expA-4","sparse_above_average","expA-4_sub122",500,"training",252,250,250,0
"1234","expA-4","sparse_above_average","expA-4_sub122",500,"test",252,250,250,0
"1235","expA-4","sparse_above_average","expA-4_sub123",500,"training",252,250,225,-25
"1236","expA-4","sparse_above_average","expA-4_sub123",500,"test",252,230,230,0
"1237","expA-4","sparse_above_average","expA-4_sub124",500,"training",252,125,240,115
"1238","expA-4","sparse_above_average","expA-4_sub124",500,"test",252,235,280,45
"1239","expA-4","sparse_above_average","expA-4_sub125",500,"training",252,300,250,-50
"1240","expA-4","sparse_above_average","expA-4_sub125",500,"test",252,255,250,-5
"1241","expA-4","sparse_above_average","expA-4_sub126",500,"training",252,200,235,35
"1242","expA-4","sparse_above_average","expA-4_sub126",500,"test",252,235,264,29
"1243","expA-4","sparse_above_average","expA-4_sub127",500,"training",252,3,260,257
"1244","expA-4","sparse_above_average","expA-4_sub127",500,"test",252,270,270,0
"1245","expA-4","sparse_above_average","expA-4_sub128",500,"training",252,300,190,-110
"1246","expA-4","sparse_above_average","expA-4_sub128",500,"test",252,242,290,48
"1247","expA-4","sparse_above_average","expA-4_sub129",500,"training",252,300,210,-90
"1248","expA-4","sparse_above_average","expA-4_sub129",500,"test",252,300,230,-70
"1249","expA-4","sparse_above_average","expA-4_sub130",500,"training",252,250,250,0
"1250","expA-4","sparse_above_average","expA-4_sub130",500,"test",252,250,250,0
"1251","expA-4","sparse_above_average","expA-4_sub131",500,"training",252,100,240,140
"1252","expA-4","sparse_above_average","expA-4_sub131",500,"test",252,240,250,10
"1253","expA-4","sparse_above_average","expA-4_sub132",500,"training",252,150,255,105
"1254","expA-4","sparse_above_average","expA-4_sub132",500,"test",252,250,225,-25
"1255","expA-4","sparse_above_average","expA-4_sub133",500,"training",252,200,200,0
"1256","expA-4","sparse_above_average","expA-4_sub133",500,"test",252,200,200,0
"1257","expA-4","sparse_above_average","expA-4_sub134",500,"training",252,5,250,245
"1258","expA-4","sparse_above_average","expA-4_sub134",500,"test",252,250,250,0
"1259","expA-4","sparse_above_average","expA-4_sub135",500,"training",252,150,250,100
"1260","expA-4","sparse_above_average","expA-4_sub135",500,"test",252,250,260,10
"1261","expA-4","sparse_above_average","expA-4_sub136",500,"training",252,200,240,40
"1262","expA-4","sparse_above_average","expA-4_sub136",500,"test",252,270,260,-10
"1263","expA-4","sparse_above_average","expA-4_sub137",500,"training",252,300,235,-65
"1264","expA-4","sparse_above_average","expA-4_sub137",500,"test",252,245,245,0
"1265","expA-4","sparse_above_average","expA-4_sub138",500,"training",252,200,200,0
"1266","expA-4","sparse_above_average","expA-4_sub138",500,"test",252,250,250,0
"1267","expA-4","sparse_above_average","expA-4_sub139",500,"training",252,250,210,-40
"1268","expA-4","sparse_above_average","expA-4_sub139",500,"test",252,244,275,31
"1269","expA-4","sparse_above_average","expA-4_sub140",500,"training",252,150,250,100
"1270","expA-4","sparse_above_average","expA-4_sub140",500,"test",252,260,225,-35
"1271","expA-4","sparse_above_average","expA-4_sub141",500,"training",252,200,225,25
"1272","expA-4","sparse_above_average","expA-4_sub141",500,"test",252,235,275,40
"1273","expA-4","sparse_above_average","expA-4_sub142",500,"training",252,300,260,-40
"1274","expA-4","sparse_above_average","expA-4_sub142",500,"test",252,260,260,0
"1275","expA-4","sparse_above_average","expA-4_sub143",500,"training",252,3,232,229
"1276","expA-4","sparse_above_average","expA-4_sub143",500,"test",252,234,278,44
"1277","expA-4","sparse_above_average","expA-4_sub144",500,"training",252,200,218,18
"1278","expA-4","sparse_above_average","expA-4_sub144",500,"test",252,260,290,30
"1279","expA-4","sparse_above_average","expA-4_sub145",500,"training",252,250,260,10
"1280","expA-4","sparse_above_average","expA-4_sub145",500,"test",252,250,250,0
"1281","expA-4","sparse_above_average","expA-4_sub146",500,"training",252,350,260,-90
"1282","expA-4","sparse_above_average","expA-4_sub146",500,"test",252,260,280,20
"1283","expA-4","sparse_above_average","expA-4_sub147",500,"training",252,4,232,228
"1284","expA-4","sparse_above_average","expA-4_sub147",500,"test",252,245,256,11
"1285","expA-4","sparse_above_average","expA-4_sub148",500,"training",252,100,241,141
"1286","expA-4","sparse_above_average","expA-4_sub148",500,"test",252,255,255,0
"1287","expA-4","sparse_above_average","expA-4_sub149",500,"training",252,200,260,60
"1288","expA-4","sparse_above_average","expA-4_sub149",500,"test",252,250,230,-20
"1289","expA-4","sparse_above_average","expA-4_sub150",500,"training",252,100,245,145
"1290","expA-4","sparse_above_average","expA-4_sub150",500,"test",252,245,260,15
"1291","expA-4","sparse_above_average","expA-4_sub151",500,"training",252,50,245,195
"1292","expA-4","sparse_above_average","expA-4_sub151",500,"test",252,245,300,55
"1293","expA-4","sparse_above_average","expA-4_sub152",500,"training",252,3,230,227
"1294","expA-4","sparse_above_average","expA-4_sub152",500,"test",252,257,257,0
"1295","expA-4","sparse_above_average","expA-4_sub153",500,"training",252,100,235,135
"1296","expA-4","sparse_above_average","expA-4_sub153",500,"test",252,240,275,35
"1297","expA-4","sparse_above_average","expA-4_sub154",500,"training",252,4,240,236
"1298","expA-4","sparse_above_average","expA-4_sub154",500,"test",252,240,270,30
"1299","expA-4","sparse_above_average","expA-4_sub155",500,"training",252,200,250,50
"1300","expA-4","sparse_above_average","expA-4_sub155",500,"test",252,250,300,50
"1301","expA-4","sparse_above_average","expA-4_sub156",500,"training",252,250,250,0
"1302","expA-4","sparse_above_average","expA-4_sub156",500,"test",252,250,260,10
"1303","expA-4","sparse_above_average","expA-4_sub157",500,"training",252,300,270,-30
"1304","expA-4","sparse_above_average","expA-4_sub157",500,"test",252,260,260,0
"1305","expA-4","sparse_above_average","expA-4_sub158",500,"training",252,100,200,100
"1306","expA-4","sparse_above_average","expA-4_sub158",500,"test",252,230,250,20
"1307","expA-4","sparse_above_average","expA-4_sub159",500,"training",252,150,265,115
"1308","expA-4","sparse_above_average","expA-4_sub159",500,"test",252,254,245,-9
"1309","expA-4","sparse_above_average","expA-4_sub160",500,"training",252,50,235,185
"1310","expA-4","sparse_above_average","expA-4_sub160",500,"test",252,235,250,15
"1311","expA-4","sparse_above_average","expA-4_sub161",500,"training",252,100,200,100
"1312","expA-4","sparse_above_average","expA-4_sub161",500,"test",252,220,230,10
"1313","expA-4","sparse_above_average","expA-4_sub162",500,"training",252,75,265,190
"1314","expA-4","sparse_above_average","expA-4_sub162",500,"test",252,260,270,10
"1315","expA-4","sparse_above_average","expA-4_sub163",500,"training",252,250,240,-10
"1316","expA-4","sparse_above_average","expA-4_sub163",500,"test",252,250,294,44
"1317","expA-4","sparse_above_average","expA-4_sub164",500,"training",252,100,250,150
"1318","expA-4","sparse_above_average","expA-4_sub164",500,"test",252,250,220,-30
"1319","expA-4","sparse_above_average","expA-4_sub165",500,"training",252,5,200,195
"1320","expA-4","sparse_above_average","expA-4_sub165",500,"test",252,250,230,-20
"1321","expA-4","sparse_above_average","expA-4_sub166",500,"training",252,100,250,150
"1322","expA-4","sparse_above_average","expA-4_sub166",500,"test",252,240,275,35
"1323","expA-4","sparse_above_average","expA-4_sub167",500,"training",252,50,250,200
"1324","expA-4","sparse_above_average","expA-4_sub167",500,"test",252,250,225,-25
"1325","expA-4","sparse_above_average","expA-4_sub168",500,"training",252,200,250,50
"1326","expA-4","sparse_above_average","expA-4_sub168",500,"test",252,250,300,50
"1327","expA-4","sparse_above_average","expA-4_sub169",500,"training",252,200,250,50
"1328","expA-4","sparse_above_average","expA-4_sub169",500,"test",252,250,300,50
"1329","expA-4","sparse_above_average","expA-4_sub170",500,"training",252,300,250,-50
"1330","expA-4","sparse_above_average","expA-4_sub170",500,"test",252,250,270,20
"1331","expA-4","sparse_above_average","expA-4_sub171",500,"training",252,3,280,277
"1332","expA-4","sparse_above_average","expA-4_sub171",500,"test",252,280,250,-30
"1333","expA-4","sparse_above_average","expA-4_sub172",500,"training",252,100,250,150
"1334","expA-4","sparse_above_average","expA-4_sub172",500,"test",252,250,300,50
"1335","expA-4","sparse_above_average","expA-4_sub173",500,"training",252,300,255,-45
"1336","expA-4","sparse_above_average","expA-4_sub173",500,"test",252,256,225,-31
"1337","expA-4","sparse_above_average","expA-4_sub174",500,"training",252,200,240,40
"1338","expA-4","sparse_above_average","expA-4_sub174",500,"test",252,260,290,30
"1339","expA-4","sparse_above_average","expA-4_sub175",500,"training",252,50,250,200
"1340","expA-4","sparse_above_average","expA-4_sub175",500,"test",252,230,275,45
"1341","expA-4","sparse_above_average","expA-4_sub176",500,"training",252,250,250,0
"1342","expA-4","sparse_above_average","expA-4_sub176",500,"test",252,250,250,0
"1343","expA-4","sparse_above_average","expA-4_sub177",500,"training",252,250,260,10
"1344","expA-4","sparse_above_average","expA-4_sub177",500,"test",252,240,280,40
"1345","expA-4","sparse_above_average","expA-4_sub178",500,"training",252,2,300,298
"1346","expA-4","sparse_above_average","expA-4_sub178",500,"test",252,280,250,-30
"1347","expA-4","sparse_above_average","expA-4_sub179",500,"training",252,250,241,-9
"1348","expA-4","sparse_above_average","expA-4_sub179",500,"test",252,240,276,36
"1349","expA-4","sparse_above_average","expA-4_sub180",500,"training",252,100,290,190
"1350","expA-4","sparse_above_average","expA-4_sub180",500,"test",252,255,254,-1
"1351","expA-4","sparse_above_average","expA-4_sub181",500,"training",252,300,285,-15
"1352","expA-4","sparse_above_average","expA-4_sub181",500,"test",252,260,260,0
"1353","expA-4","sparse_above_average","expA-4_sub182",500,"training",252,100,250,150
"1354","expA-4","sparse_above_average","expA-4_sub182",500,"test",252,250,250,0
"1355","expA-4","sparse_above_average","expA-4_sub183",500,"training",252,100,250,150
"1356","expA-4","sparse_above_average","expA-4_sub183",500,"test",252,250,300,50
"1357","expA-4","sparse_above_average","expA-4_sub184",500,"training",252,250,250,0
"1358","expA-4","sparse_above_average","expA-4_sub184",500,"test",252,250,250,0
"1359","expA-4","sparse_above_average","expA-4_sub185",500,"training",252,100,250,150
"1360","expA-4","sparse_above_average","expA-4_sub185",500,"test",252,250,220,-30
"1361","expA-4","sparse_above_average","expA-4_sub186",500,"training",252,300,230,-70
"1362","expA-4","sparse_above_average","expA-4_sub186",500,"test",252,250,255,5
"1363","expA-4","sparse_above_average","expA-4_sub187",500,"training",252,250,240,-10
"1364","expA-4","sparse_above_average","expA-4_sub187",500,"test",252,240,240,0
"1365","expA-4","sparse_above_average","expA-4_sub188",500,"training",252,350,240,-110
"1366","expA-4","sparse_above_average","expA-4_sub188",500,"test",252,235,260,25
"1367","expA-4","sparse_above_average","expA-4_sub189",500,"training",252,30,250,220
"1368","expA-4","sparse_above_average","expA-4_sub189",500,"test",252,250,250,0
"1369","expA-4","sparse_above_average","expA-4_sub190",500,"training",252,200,235,35
"1370","expA-4","sparse_above_average","expA-4_sub190",500,"test",252,200,220,20
"1371","expA-4","sparse_above_average","expA-4_sub191",500,"training",252,100,200,100
"1372","expA-4","sparse_above_average","expA-4_sub191",500,"test",252,260,285,25
"1373","expA-4","sparse_above_average","expA-4_sub192",500,"training",252,150,222,72
"1374","expA-4","sparse_above_average","expA-4_sub192",500,"test",252,240,230,-10
"1375","expA-4","sparse_above_average","expA-4_sub193",500,"training",252,200,200,0
"1376","expA-4","sparse_above_average","expA-4_sub193",500,"test",252,240,240,0
"1377","expA-4","sparse_above_average","expA-4_sub194",500,"training",252,200,240,40
"1378","expA-4","sparse_above_average","expA-4_sub194",500,"test",252,250,280,30
"1379","expA-4","sparse_above_average","expA-4_sub195",500,"training",252,250,220,-30
"1380","expA-4","sparse_above_average","expA-4_sub195",500,"test",252,250,220,-30
"1381","expA-4","sparse_above_average","expA-4_sub196",500,"training",252,200,260,60
"1382","expA-4","sparse_above_average","expA-4_sub196",500,"test",252,260,280,20
"1383","expA-4","sparse_above_average","expA-4_sub197",500,"training",252,200,260,60
"1384","expA-4","sparse_above_average","expA-4_sub197",500,"test",252,255,280,25
"1385","expA-4","sparse_above_average","expA-4_sub198",500,"training",252,200,245,45
"1386","expA-4","sparse_above_average","expA-4_sub198",500,"test",252,250,275,25
"1387","expA-4","sparse_above_average","expA-4_sub199",500,"training",252,150,260,110
"1388","expA-4","sparse_above_average","expA-4_sub199",500,"test",252,250,220,-30
"1389","expA-4","sparse_above_average","expA-4_sub200",500,"training",252,250,250,0
"1390","expA-4","sparse_above_average","expA-4_sub200",500,"test",252,250,250,0
"1391","expA-4","sparse_above_average","expA-4_sub201",500,"training",252,200,250,50
"1392","expA-4","sparse_above_average","expA-4_sub201",500,"test",252,260,280,20
"1393","expA-4","sparse_above_average","expA-4_sub202",500,"training",252,200,230,30
"1394","expA-4","sparse_above_average","expA-4_sub202",500,"test",252,250,250,0
"1395","expA-4","sparse_above_average","expA-4_sub203",500,"training",252,100,250,150
"1396","expA-4","sparse_above_average","expA-4_sub203",500,"test",252,250,280,30
"1397","expA-4","sparse_above_average","expA-4_sub204",500,"training",252,100,250,150
"1398","expA-4","sparse_above_average","expA-4_sub204",500,"test",252,250,240,-10
"1399","expA-4","sparse_above_average","expA-4_sub205",500,"training",252,250,250,0
"1400","expA-4","sparse_above_average","expA-4_sub205",500,"test",252,250,250,0
"1401","expA-4","sparse_above_average","expA-4_sub206",500,"training",252,100,245,145
"1402","expA-4","sparse_above_average","expA-4_sub206",500,"test",252,225,275,50
"1403","expA-4","sparse_above_average","expA-4_sub207",500,"training",252,250,250,0
"1404","expA-4","sparse_above_average","expA-4_sub207",500,"test",252,250,250,0
"1405","expA-4","sparse_above_average","expA-4_sub208",500,"training",252,200,222,22
"1406","expA-4","sparse_above_average","expA-4_sub208",500,"test",252,222,255,33
"1407","expA-4","sparse_above_average","expA-4_sub209",500,"training",252,200,230,30
"1408","expA-4","sparse_above_average","expA-4_sub209",500,"test",252,240,240,0
"1409","expA-4","sparse_above_average","expA-4_sub210",500,"training",252,200,250,50
"1410","expA-4","sparse_above_average","expA-4_sub210",500,"test",252,250,250,0
"1411","expA-4","sparse_above_average","expA-4_sub211",500,"training",252,3,250,247
"1412","expA-4","sparse_above_average","expA-4_sub211",500,"test",252,250,250,0
"1413","expA-4","sparse_above_average","expA-4_sub212",500,"training",252,50,255,205
"1414","expA-4","sparse_above_average","expA-4_sub212",500,"test",252,255,275,20
"1415","expA-4","sparse_above_average","expA-4_sub213",500,"training",252,300,280,-20
"1416","expA-4","sparse_above_average","expA-4_sub213",500,"test",252,250,277,27
"1417","expA-4","sparse_above_average","expA-4_sub214",500,"training",252,200,231,31
"1418","expA-4","sparse_above_average","expA-4_sub214",500,"test",252,238,248,10
"1419","expA-4","sparse_above_average","expA-4_sub215",500,"training",252,50,250,200
"1420","expA-4","sparse_above_average","expA-4_sub215",500,"test",252,250,285,35
"1421","expA-4","sparse_above_average","expA-4_sub216",500,"training",252,300,240,-60
"1422","expA-4","sparse_above_average","expA-4_sub216",500,"test",252,250,230,-20
"1423","expA-4","sparse_above_average","expA-4_sub217",500,"training",252,100,220,120
"1424","expA-4","sparse_above_average","expA-4_sub217",500,"test",252,270,280,10
"1425","expA-4","sparse_above_average","expA-4_sub218",500,"training",252,100,230,130
"1426","expA-4","sparse_above_average","expA-4_sub218",500,"test",252,250,300,50
"1427","expA-4","sparse_above_average","expA-4_sub219",500,"training",252,100,250,150
"1428","expA-4","sparse_above_average","expA-4_sub219",500,"test",252,300,300,0
"1429","expA-4","sparse_above_average","expA-4_sub220",500,"training",252,150,245,95
"1430","expA-4","sparse_above_average","expA-4_sub220",500,"test",252,240,275,35
"1431","expA-4","sparse_above_average","expA-4_sub221",500,"training",252,5,332,327
"1432","expA-4","sparse_above_average","expA-4_sub221",500,"test",252,200,262,62
"1433","expA-4","sparse_above_average","expA-4_sub222",500,"training",252,5,260,255
"1434","expA-4","sparse_above_average","expA-4_sub222",500,"test",252,250,250,0
"1435","expA-4","sparse_above_average","expA-4_sub223",500,"training",252,3,300,297
"1436","expA-4","sparse_above_average","expA-4_sub223",500,"test",252,250,250,0
"1437","expA-4","sparse_above_average","expA-4_sub224",500,"training",252,5,210,205
"1438","expA-4","sparse_above_average","expA-4_sub224",500,"test",252,250,285,35
"1439","expA-4","sparse_above_average","expA-4_sub225",500,"training",252,5,280,275
"1440","expA-4","sparse_above_average","expA-4_sub225",500,"test",252,230,230,0
"1441","expA-4","sparse_above_average","expA-4_sub226",500,"training",252,5,250,245
"1442","expA-4","sparse_above_average","expA-4_sub226",500,"test",252,250,250,0
"1443","expA-4","sparse_above_average","expA-4_sub227",500,"training",252,350,250,-100
"1444","expA-4","sparse_above_average","expA-4_sub227",500,"test",252,260,260,0
"1445","expA-4","sparse_above_average","expA-4_sub228",500,"training",252,250,200,-50
"1446","expA-4","sparse_above_average","expA-4_sub228",500,"test",252,220,210,-10
"1447","expA-4","sparse_above_average","expA-4_sub229",500,"training",252,3,250,247
"1448","expA-4","sparse_above_average","expA-4_sub229",500,"test",252,255,255,0
"1449","exp2B","sparse_below_average","exp2B_sub001",500,"training",248,500,244,-256
"1450","exp2B","sparse_below_average","exp2B_sub001",500,"test",248,233,234,1
"1451","exp2B","sparse_below_average","exp2B_sub002",500,"training",248,400,250,-150
"1452","exp2B","sparse_below_average","exp2B_sub002",500,"test",248,250,275,25
"1453","exp2B","sparse_below_average","exp2B_sub003",500,"training",248,234,234,0
"1454","exp2B","sparse_below_average","exp2B_sub003",500,"test",248,240,213,-27
"1455","exp2B","sparse_below_average","exp2B_sub004",500,"training",248,350,245,-105
"1456","exp2B","sparse_below_average","exp2B_sub004",500,"test",248,240,240,0
"1457","exp2B","sparse_below_average","exp2B_sub005",500,"training",248,200,250,50
"1458","exp2B","sparse_below_average","exp2B_sub005",500,"test",248,240,240,0
"1459","exp2B","sparse_below_average","exp2B_sub006",500,"training",248,200,250,50
"1460","exp2B","sparse_below_average","exp2B_sub006",500,"test",248,250,250,0
"1461","exp2B","sparse_below_average","exp2B_sub007",500,"training",248,200,200,0
"1462","exp2B","sparse_below_average","exp2B_sub007",500,"test",248,220,300,80
"1463","exp2B","sparse_below_average","exp2B_sub008",500,"training",248,100,325,225
"1464","exp2B","sparse_below_average","exp2B_sub008",500,"test",248,235,275,40
"1465","exp2B","sparse_below_average","exp2B_sub009",500,"training",248,50,262,212
"1466","exp2B","sparse_below_average","exp2B_sub009",500,"test",248,260,210,-50
"1467","exp2B","sparse_below_average","exp2B_sub010",500,"training",248,300,280,-20
"1468","exp2B","sparse_below_average","exp2B_sub010",500,"test",248,250,220,-30
"1469","exp2B","sparse_below_average","exp2B_sub011",500,"training",248,300,225,-75
"1470","exp2B","sparse_below_average","exp2B_sub011",500,"test",248,235,295,60
"1471","exp2B","sparse_below_average","exp2B_sub012",500,"training",248,200,250,50
"1472","exp2B","sparse_below_average","exp2B_sub012",500,"test",248,200,200,0
"1473","exp2B","sparse_below_average","exp2B_sub013",500,"training",248,200,235,35
"1474","exp2B","sparse_below_average","exp2B_sub013",500,"test",248,235,265,30
"1475","exp2B","sparse_below_average","exp2B_sub014",500,"training",248,100,100,0
"1476","exp2B","sparse_below_average","exp2B_sub014",500,"test",248,250,200,-50
"1477","exp2B","sparse_below_average","exp2B_sub015",500,"training",248,250,250,0
"1478","exp2B","sparse_below_average","exp2B_sub015",500,"test",248,250,220,-30
"1479","exp2B","sparse_below_average","exp2B_sub016",500,"training",248,300,300,0
"1480","exp2B","sparse_below_average","exp2B_sub016",500,"test",248,250,250,0
"1481","exp2B","sparse_below_average","exp2B_sub017",500,"training",248,100,250,150
"1482","exp2B","sparse_below_average","exp2B_sub017",500,"test",248,259,230,-29
"1483","exp2B","sparse_below_average","exp2B_sub018",500,"training",248,300,240,-60
"1484","exp2B","sparse_below_average","exp2B_sub018",500,"test",248,275,280,5
"1485","exp2B","sparse_below_average","exp2B_sub019",500,"training",248,100,250,150
"1486","exp2B","sparse_below_average","exp2B_sub019",500,"test",248,240,210,-30
"1487","exp2B","sparse_below_average","exp2B_sub020",500,"training",248,25,220,195
"1488","exp2B","sparse_below_average","exp2B_sub020",500,"test",248,230,230,0
"1489","exp2B","sparse_below_average","exp2B_sub021",500,"training",248,50,242,192
"1490","exp2B","sparse_below_average","exp2B_sub021",500,"test",248,234,232,-2
"1491","exp2B","sparse_below_average","exp2B_sub022",500,"training",248,200,250,50
"1492","exp2B","sparse_below_average","exp2B_sub022",500,"test",248,250,350,100
"1493","exp2B","sparse_below_average","exp2B_sub023",500,"training",248,200,325,125
"1494","exp2B","sparse_below_average","exp2B_sub023",500,"test",248,245,310,65
"1495","exp2B","sparse_below_average","exp2B_sub024",500,"training",248,200,225,25
"1496","exp2B","sparse_below_average","exp2B_sub024",500,"test",248,250,225,-25
"1497","exp2B","sparse_below_average","exp2B_sub025",500,"training",248,30,235,205
"1498","exp2B","sparse_below_average","exp2B_sub025",500,"test",248,240,250,10
"1499","exp2B","sparse_below_average","exp2B_sub026",500,"training",248,200,250,50
"1500","exp2B","sparse_below_average","exp2B_sub026",500,"test",248,225,300,75
"1501","exp2B","sparse_below_average","exp2B_sub027",500,"training",248,75,275,200
"1502","exp2B","sparse_below_average","exp2B_sub027",500,"test",248,240,278,38
"1503","exp2B","sparse_below_average","exp2B_sub028",500,"training",248,250,249,-1
"1504","exp2B","sparse_below_average","exp2B_sub028",500,"test",248,250,255,5
"1505","exp2B","sparse_below_average","exp2B_sub029",500,"training",248,250,200,-50
"1506","exp2B","sparse_below_average","exp2B_sub029",500,"test",248,240,300,60
"1507","exp2B","sparse_below_average","exp2B_sub030",500,"training",248,50,230,180
"1508","exp2B","sparse_below_average","exp2B_sub030",500,"test",248,240,270,30
"1509","exp2B","sparse_below_average","exp2B_sub031",500,"training",248,10,255,245
"1510","exp2B","sparse_below_average","exp2B_sub031",500,"test",248,240,200,-40
"1511","exp2B","sparse_below_average","exp2B_sub032",500,"training",248,200,234,34
"1512","exp2B","sparse_below_average","exp2B_sub032",500,"test",248,243,340,97
"1513","exp2B","sparse_below_average","exp2B_sub033",500,"training",248,300,220,-80
"1514","exp2B","sparse_below_average","exp2B_sub033",500,"test",248,230,220,-10
"1515","exp2B","sparse_below_average","exp2B_sub034",500,"training",248,50,235,185
"1516","exp2B","sparse_below_average","exp2B_sub034",500,"test",248,240,250,10
"1517","exp2B","sparse_below_average","exp2B_sub035",500,"training",248,200,240,40
"1518","exp2B","sparse_below_average","exp2B_sub035",500,"test",248,232,230,-2
"1519","exp2B","sparse_below_average","exp2B_sub036",500,"training",248,50,250,200
"1520","exp2B","sparse_below_average","exp2B_sub036",500,"test",248,250,200,-50
"1521","exp2B","sparse_below_average","exp2B_sub037",500,"training",248,250,260,10
"1522","exp2B","sparse_below_average","exp2B_sub037",500,"test",248,240,200,-40
"1523","exp2B","sparse_below_average","exp2B_sub038",500,"training",248,30,250,220
"1524","exp2B","sparse_below_average","exp2B_sub038",500,"test",248,250,225,-25
"1525","exp2B","sparse_above_average","exp2B_sub039",500,"training",252,225,240,15
"1526","exp2B","sparse_above_average","exp2B_sub039",500,"test",252,250,275,25
"1527","exp2B","sparse_above_average","exp2B_sub040",500,"training",252,150,250,100
"1528","exp2B","sparse_above_average","exp2B_sub040",500,"test",252,220,228,8
"1529","exp2B","sparse_above_average","exp2B_sub041",500,"training",252,250,250,0
"1530","exp2B","sparse_above_average","exp2B_sub041",500,"test",252,250,300,50
"1531","exp2B","sparse_above_average","exp2B_sub042",500,"training",252,100,200,100
"1532","exp2B","sparse_above_average","exp2B_sub042",500,"test",252,250,265,15
"1533","exp2B","sparse_above_average","exp2B_sub043",500,"training",252,100,250,150
"1534","exp2B","sparse_above_average","exp2B_sub043",500,"test",252,250,200,-50
"1535","exp2B","sparse_above_average","exp2B_sub044",500,"training",252,50,250,200
"1536","exp2B","sparse_above_average","exp2B_sub044",500,"test",252,250,225,-25
"1537","exp2B","sparse_above_average","exp2B_sub045",500,"training",252,100,230,130
"1538","exp2B","sparse_above_average","exp2B_sub045",500,"test",252,250,270,20
"1539","exp2B","sparse_above_average","exp2B_sub046",500,"training",252,400,240,-160
"1540","exp2B","sparse_above_average","exp2B_sub046",500,"test",252,230,250,20
"1541","exp2B","sparse_above_average","exp2B_sub047",500,"training",252,100,240,140
"1542","exp2B","sparse_above_average","exp2B_sub047",500,"test",252,245,260,15
"1543","exp2B","sparse_above_average","exp2B_sub048",500,"training",252,150,230,80
"1544","exp2B","sparse_above_average","exp2B_sub048",500,"test",252,220,275,55
"1545","exp2B","sparse_above_average","exp2B_sub049",500,"training",252,150,230,80
"1546","exp2B","sparse_above_average","exp2B_sub049",500,"test",252,240,280,40
"1547","exp2B","sparse_above_average","exp2B_sub050",500,"training",252,200,225,25
"1548","exp2B","sparse_above_average","exp2B_sub050",500,"test",252,225,280,55
"1549","exp2B","sparse_above_average","exp2B_sub051",500,"training",252,300,235,-65
"1550","exp2B","sparse_above_average","exp2B_sub051",500,"test",252,245,256,11
"1551","exp2B","sparse_above_average","exp2B_sub052",500,"training",252,100,270,170
"1552","exp2B","sparse_above_average","exp2B_sub052",500,"test",252,250,250,0
"1553","exp2B","sparse_above_average","exp2B_sub053",500,"training",252,500,250,-250
"1554","exp2B","sparse_above_average","exp2B_sub053",500,"test",252,260,500,240
"1555","exp2B","sparse_above_average","exp2B_sub054",500,"training",252,150,200,50
"1556","exp2B","sparse_above_average","exp2B_sub054",500,"test",252,250,250,0
"1557","exp2B","sparse_above_average","exp2B_sub055",500,"training",252,75,231,156
"1558","exp2B","sparse_above_average","exp2B_sub055",500,"test",252,251,267,16
"1559","exp2B","sparse_above_average","exp2B_sub056",500,"training",252,300,230,-70
"1560","exp2B","sparse_above_average","exp2B_sub056",500,"test",252,255,285,30
"1561","exp2B","sparse_above_average","exp2B_sub057",500,"training",252,150,250,100
"1562","exp2B","sparse_above_average","exp2B_sub057",500,"test",252,250,250,0
"1563","exp2B","sparse_above_average","exp2B_sub058",500,"training",252,100,250,150
"1564","exp2B","sparse_above_average","exp2B_sub058",500,"test",252,250,250,0
"1565","exp2B","sparse_above_average","exp2B_sub059",500,"training",252,100,250,150
"1566","exp2B","sparse_above_average","exp2B_sub059",500,"test",252,250,300,50
"1567","exp2B","sparse_above_average","exp2B_sub060",500,"training",252,200,226,26
"1568","exp2B","sparse_above_average","exp2B_sub060",500,"test",252,248,264,16
"1569","exp2B","sparse_above_average","exp2B_sub061",500,"training",252,100,250,150
"1570","exp2B","sparse_above_average","exp2B_sub061",500,"test",252,250,330,80
"1571","exp2B","sparse_above_average","exp2B_sub062",500,"training",252,200,250,50
"1572","exp2B","sparse_above_average","exp2B_sub062",500,"test",252,250,250,0
"1573","exp2B","sparse_above_average","exp2B_sub063",500,"training",252,200,230,30
"1574","exp2B","sparse_above_average","exp2B_sub063",500,"test",252,250,279,29
"1575","exp2B","sparse_above_average","exp2B_sub064",500,"training",252,150,240,90
"1576","exp2B","sparse_above_average","exp2B_sub064",500,"test",252,245,250,5
"1577","exp2B","sparse_above_average","exp2B_sub065",500,"training",252,50,250,200
"1578","exp2B","sparse_above_average","exp2B_sub065",500,"test",252,240,310,70
"1579","exp2B","sparse_above_average","exp2B_sub066",500,"training",252,30,245,215
"1580","exp2B","sparse_above_average","exp2B_sub066",500,"test",252,245,250,5
"1581","exp2B","sparse_above_average","exp2B_sub067",500,"training",252,100,200,100
"1582","exp2B","sparse_above_average","exp2B_sub067",500,"test",252,250,275,25
"1583","exp2B","sparse_above_average","exp2B_sub068",500,"training",252,250,235,-15
"1584","exp2B","sparse_above_average","exp2B_sub068",500,"test",252,235,275,40
"1585","exp2B","sparse_above_average","exp2B_sub069",500,"training",252,100,225,125
"1586","exp2B","sparse_above_average","exp2B_sub069",500,"test",252,240,250,10
"1587","exp2B","sparse_above_average","exp2B_sub070",500,"training",252,200,220,20
"1588","exp2B","sparse_above_average","exp2B_sub070",500,"test",252,250,265,15
"1589","exp2B","sparse_above_average","exp2B_sub071",500,"training",252,200,250,50
"1590","exp2B","sparse_above_average","exp2B_sub071",500,"test",252,250,260,10
"1591","exp2B","sparse_above_average","exp2B_sub072",500,"training",252,200,250,50
"1592","exp2B","sparse_above_average","exp2B_sub072",500,"test",252,250,250,0
"1593","exp2B","sparse_above_average","exp2B_sub073",500,"training",252,100,210,110
"1594","exp2B","sparse_above_average","exp2B_sub073",500,"test",252,222,300,78
"1595","exp2B","sparse_above_average","exp2B_sub074",500,"training",252,50,240,190
"1596","exp2B","sparse_above_average","exp2B_sub074",500,"test",252,240,210,-30
"1597","exp2B","sparse_above_average","exp2B_sub075",500,"training",252,340,230,-110
"1598","exp2B","sparse_above_average","exp2B_sub075",500,"test",252,270,270,0
"1599","exp2B","sparse_above_average","exp2B_sub076",500,"training",252,20,250,230
"1600","exp2B","sparse_above_average","exp2B_sub076",500,"test",252,250,300,50
"1601","exp2B","sparse_above_average","exp2B_sub077",500,"training",252,200,260,60
"1602","exp2B","sparse_above_average","exp2B_sub077",500,"test",252,260,180,-80
"1603","exp2B","sparse_above_average","exp2B_sub078",500,"training",252,250,250,0
"1604","exp2B","sparse_above_average","exp2B_sub078",500,"test",252,250,260,10
"1605","exp2B","sparse_above_average","exp2B_sub079",500,"training",252,150,250,100
"1606","exp2B","sparse_above_average","exp2B_sub079",500,"test",252,250,265,15
"1607","exp2B","sparse_above_average","exp2B_sub080",500,"training",252,250,250,0
"1608","exp2B","sparse_above_average","exp2B_sub080",500,"test",252,250,285,35
"1609","exp2B","sparse_above_average","exp2B_sub081",500,"training",252,100,235,135
"1610","exp2B","sparse_above_average","exp2B_sub081",500,"test",252,235,300,65
"1611","exp2C","sparse_below_average","exp2C_sub001",500,"training",248,210,255,45
"1612","exp2C","sparse_below_average","exp2C_sub001",500,"test",248,250,240,-10
"1613","exp2C","sparse_below_average","exp2C_sub002",500,"training",248,200,255,55
"1614","exp2C","sparse_below_average","exp2C_sub002",500,"test",248,275,275,0
"1615","exp2C","sparse_below_average","exp2C_sub003",500,"training",248,100,230,130
"1616","exp2C","sparse_below_average","exp2C_sub003",500,"test",248,200,250,50
"1617","exp2C","sparse_below_average","exp2C_sub004",500,"training",248,100,266,166
"1618","exp2C","sparse_below_average","exp2C_sub004",500,"test",248,240,153,-87
"1619","exp2C","sparse_below_average","exp2C_sub005",500,"training",248,50,250,200
"1620","exp2C","sparse_below_average","exp2C_sub005",500,"test",248,250,250,0
"1621","exp2C","sparse_below_average","exp2C_sub006",500,"training",248,500,250,-250
"1622","exp2C","sparse_below_average","exp2C_sub006",500,"test",248,250,275,25
"1623","exp2C","sparse_below_average","exp2C_sub007",500,"training",248,50,232,182
"1624","exp2C","sparse_below_average","exp2C_sub007",500,"test",248,200,288,88
"1625","exp2C","sparse_below_average","exp2C_sub008",500,"training",248,50,240,190
"1626","exp2C","sparse_below_average","exp2C_sub008",500,"test",248,240,255,15
"1627","exp2C","sparse_below_average","exp2C_sub009",500,"training",248,40,228,188
"1628","exp2C","sparse_below_average","exp2C_sub009",500,"test",248,235,247,12
"1629","exp2C","sparse_below_average","exp2C_sub010",500,"training",248,100,250,150
"1630","exp2C","sparse_below_average","exp2C_sub010",500,"test",248,250,250,0
"1631","exp2C","sparse_below_average","exp2C_sub011",500,"training",248,0,222,222
"1632","exp2C","sparse_below_average","exp2C_sub011",500,"test",248,222,22,-200
"1633","exp2C","sparse_below_average","exp2C_sub012",500,"training",248,100,235,135
"1634","exp2C","sparse_below_average","exp2C_sub012",500,"test",248,235,260,25
"1635","exp2C","sparse_below_average","exp2C_sub013",500,"training",248,5,240,235
"1636","exp2C","sparse_below_average","exp2C_sub013",500,"test",248,220,220,0
"1637","exp2C","sparse_below_average","exp2C_sub014",500,"training",248,100,225,125
"1638","exp2C","sparse_below_average","exp2C_sub014",500,"test",248,225,250,25
"1639","exp2C","sparse_below_average","exp2C_sub015",500,"training",248,150,230,80
"1640","exp2C","sparse_below_average","exp2C_sub015",500,"test",248,230,250,20
"1641","exp2C","sparse_below_average","exp2C_sub016",500,"training",248,20,240,220
"1642","exp2C","sparse_below_average","exp2C_sub016",500,"test",248,240,210,-30
"1643","exp2C","sparse_below_average","exp2C_sub017",500,"training",248,100,250,150
"1644","exp2C","sparse_below_average","exp2C_sub017",500,"test",248,250,250,0
"1645","exp2C","sparse_below_average","exp2C_sub018",500,"training",248,20,250,230
"1646","exp2C","sparse_below_average","exp2C_sub018",500,"test",248,220,200,-20
"1647","exp2C","sparse_below_average","exp2C_sub019",500,"training",248,40,240,200
"1648","exp2C","sparse_below_average","exp2C_sub019",500,"test",248,250,265,15
"1649","exp2C","sparse_below_average","exp2C_sub020",500,"training",248,200,250,50
"1650","exp2C","sparse_below_average","exp2C_sub020",500,"test",248,250,240,-10
"1651","exp2C","sparse_below_average","exp2C_sub021",500,"training",248,200,247,47
"1652","exp2C","sparse_below_average","exp2C_sub021",500,"test",248,248,235,-13
"1653","exp2C","sparse_below_average","exp2C_sub022",500,"training",248,150,230,80
"1654","exp2C","sparse_below_average","exp2C_sub022",500,"test",248,230,200,-30
"1655","exp2C","sparse_below_average","exp2C_sub023",500,"training",248,200,230,30
"1656","exp2C","sparse_below_average","exp2C_sub023",500,"test",248,235,265,30
"1657","exp2C","sparse_below_average","exp2C_sub024",500,"training",248,250,220,-30
"1658","exp2C","sparse_below_average","exp2C_sub024",500,"test",248,220,300,80
"1659","exp2C","sparse_below_average","exp2C_sub025",500,"training",248,20,220,200
"1660","exp2C","sparse_below_average","exp2C_sub025",500,"test",248,230,200,-30
"1661","exp2C","sparse_below_average","exp2C_sub026",500,"training",248,10,240,230
"1662","exp2C","sparse_below_average","exp2C_sub026",500,"test",248,225,225,0
"1663","exp2C","sparse_below_average","exp2C_sub027",500,"training",248,250,230,-20
"1664","exp2C","sparse_below_average","exp2C_sub027",500,"test",248,230,200,-30
"1665","exp2C","sparse_below_average","exp2C_sub028",500,"training",248,100,256,156
"1666","exp2C","sparse_below_average","exp2C_sub028",500,"test",248,231,275,44
"1667","exp2C","sparse_below_average","exp2C_sub029",500,"training",248,75,250,175
"1668","exp2C","sparse_below_average","exp2C_sub029",500,"test",248,250,200,-50
"1669","exp2C","sparse_below_average","exp2C_sub030",500,"training",248,100,300,200
"1670","exp2C","sparse_below_average","exp2C_sub030",500,"test",248,220,256,36
"1671","exp2C","sparse_below_average","exp2C_sub031",500,"training",248,175,250,75
"1672","exp2C","sparse_below_average","exp2C_sub031",500,"test",248,250,220,-30
"1673","exp2C","sparse_below_average","exp2C_sub032",500,"training",248,50,240,190
"1674","exp2C","sparse_below_average","exp2C_sub032",500,"test",248,220,230,10
"1675","exp2C","sparse_below_average","exp2C_sub033",500,"training",248,100,200,100
"1676","exp2C","sparse_below_average","exp2C_sub033",500,"test",248,245,220,-25
"1677","exp2C","sparse_below_average","exp2C_sub034",500,"training",248,25,250,225
"1678","exp2C","sparse_below_average","exp2C_sub034",500,"test",248,250,250,0
"1679","exp2C","sparse_below_average","exp2C_sub035",500,"training",248,200,240,40
"1680","exp2C","sparse_below_average","exp2C_sub035",500,"test",248,240,240,0
"1681","exp2C","sparse_below_average","exp2C_sub036",500,"training",248,250,255,5
"1682","exp2C","sparse_below_average","exp2C_sub036",500,"test",248,255,250,-5
"1683","exp2C","sparse_below_average","exp2C_sub037",500,"training",248,100,240,140
"1684","exp2C","sparse_below_average","exp2C_sub037",500,"test",248,240,230,-10
"1685","exp2C","sparse_below_average","exp2C_sub038",500,"training",248,100,100,0
"1686","exp2C","sparse_below_average","exp2C_sub038",500,"test",248,200,200,0
"1687","exp2C","sparse_below_average","exp2C_sub039",500,"training",248,250,230,-20
"1688","exp2C","sparse_below_average","exp2C_sub039",500,"test",248,250,280,30
"1689","exp2C","sparse_below_average","exp2C_sub040",500,"training",248,100,225,125
"1690","exp2C","sparse_below_average","exp2C_sub040",500,"test",248,240,214,-26
"1691","exp2C","sparse_below_average","exp2C_sub041",500,"training",248,100,240,140
"1692","exp2C","sparse_below_average","exp2C_sub041",500,"test",248,262,240,-22
"1693","exp2C","sparse_below_average","exp2C_sub042",500,"training",248,150,244,94
"1694","exp2C","sparse_below_average","exp2C_sub042",500,"test",248,245,229,-16
"1695","exp2C","sparse_below_average","exp2C_sub043",500,"training",248,250,235,-15
"1696","exp2C","sparse_below_average","exp2C_sub043",500,"test",248,225,200,-25
"1697","exp2C","sparse_below_average","exp2C_sub044",500,"training",248,50,250,200
"1698","exp2C","sparse_below_average","exp2C_sub044",500,"test",248,250,275,25
"1699","exp2C","sparse_below_average","exp2C_sub045",500,"training",248,250,235,-15
"1700","exp2C","sparse_below_average","exp2C_sub045",500,"test",248,250,270,20
"1701","exp2C","sparse_below_average","exp2C_sub046",500,"training",248,100,225,125
"1702","exp2C","sparse_below_average","exp2C_sub046",500,"test",248,250,300,50
"1703","exp2C","sparse_below_average","exp2C_sub047",500,"training",248,50,255,205
"1704","exp2C","sparse_below_average","exp2C_sub047",500,"test",248,243,240,-3
"1705","exp2C","sparse_below_average","exp2C_sub048",500,"training",248,200,225,25
"1706","exp2C","sparse_below_average","exp2C_sub048",500,"test",248,250,250,0
"1707","exp2C","sparse_below_average","exp2C_sub049",500,"training",248,300,228,-72
"1708","exp2C","sparse_below_average","exp2C_sub049",500,"test",248,236,338,102
"1709","exp2C","sparse_below_average","exp2C_sub050",500,"training",248,150,250,100
"1710","exp2C","sparse_below_average","exp2C_sub050",500,"test",248,200,225,25
"1711","exp2C","sparse_below_average","exp2C_sub051",500,"training",248,3,250,247
"1712","exp2C","sparse_below_average","exp2C_sub051",500,"test",248,250,230,-20
"1713","exp2C","sparse_above_average","exp2C_sub052",500,"training",252,50,250,200
"1714","exp2C","sparse_above_average","exp2C_sub052",500,"test",252,250,262,12
"1715","exp2C","sparse_above_average","exp2C_sub053",500,"training",252,20,300,280
"1716","exp2C","sparse_above_average","exp2C_sub053",500,"test",252,260,188,-72
"1717","exp2C","sparse_above_average","exp2C_sub054",500,"training",252,100,200,100
"1718","exp2C","sparse_above_average","exp2C_sub054",500,"test",252,200,250,50
"1719","exp2C","sparse_above_average","exp2C_sub055",500,"training",252,100,250,150
"1720","exp2C","sparse_above_average","exp2C_sub055",500,"test",252,250,260,10
"1721","exp2C","sparse_above_average","exp2C_sub056",500,"training",252,100,240,140
"1722","exp2C","sparse_above_average","exp2C_sub056",500,"test",252,240,350,110
"1723","exp2C","sparse_above_average","exp2C_sub057",500,"training",252,200,250,50
"1724","exp2C","sparse_above_average","exp2C_sub057",500,"test",252,250,300,50
"1725","exp2C","sparse_above_average","exp2C_sub058",500,"training",252,500,250,-250
"1726","exp2C","sparse_above_average","exp2C_sub058",500,"test",252,250,350,100
"1727","exp2C","sparse_above_average","exp2C_sub059",500,"training",252,50,240,190
"1728","exp2C","sparse_above_average","exp2C_sub059",500,"test",252,250,260,10
"1729","exp2C","sparse_above_average","exp2C_sub060",500,"training",252,125,250,125
"1730","exp2C","sparse_above_average","exp2C_sub060",500,"test",252,250,275,25
"1731","exp2C","sparse_above_average","exp2C_sub061",500,"training",252,10,240,230
"1732","exp2C","sparse_above_average","exp2C_sub061",500,"test",252,240,275,35
"1733","exp2C","sparse_above_average","exp2C_sub062",500,"training",252,50,255,205
"1734","exp2C","sparse_above_average","exp2C_sub062",500,"test",252,255,220,-35
"1735","exp2C","sparse_above_average","exp2C_sub063",500,"training",252,15,245,230
"1736","exp2C","sparse_above_average","exp2C_sub063",500,"test",252,245,250,5
"1737","exp2C","sparse_above_average","exp2C_sub064",500,"training",252,200,230,30
"1738","exp2C","sparse_above_average","exp2C_sub064",500,"test",252,230,235,5
"1739","exp2C","sparse_above_average","exp2C_sub065",500,"training",252,100,200,100
"1740","exp2C","sparse_above_average","exp2C_sub065",500,"test",252,250,300,50
"1741","exp2C","sparse_above_average","exp2C_sub066",500,"training",252,100,240,140
"1742","exp2C","sparse_above_average","exp2C_sub066",500,"test",252,230,260,30
"1743","exp2C","sparse_above_average","exp2C_sub067",500,"training",252,100,240,140
"1744","exp2C","sparse_above_average","exp2C_sub067",500,"test",252,240,260,20
"1745","exp2C","sparse_above_average","exp2C_sub068",500,"training",252,20,250,230
"1746","exp2C","sparse_above_average","exp2C_sub068",500,"test",252,250,230,-20
"1747","exp2C","sparse_above_average","exp2C_sub069",500,"training",252,10,200,190
"1748","exp2C","sparse_above_average","exp2C_sub069",500,"test",252,250,250,0
"1749","exp2C","sparse_above_average","exp2C_sub070",500,"training",252,200,235,35
"1750","exp2C","sparse_above_average","exp2C_sub070",500,"test",252,235,240,5
"1751","exp2C","sparse_above_average","exp2C_sub071",500,"training",252,50,250,200
"1752","exp2C","sparse_above_average","exp2C_sub071",500,"test",252,250,275,25
"1753","exp2C","sparse_above_average","exp2C_sub072",500,"training",252,234,250,16
"1754","exp2C","sparse_above_average","exp2C_sub072",500,"test",252,235,235,0
"1755","exp2C","sparse_above_average","exp2C_sub073",500,"training",252,150,250,100
"1756","exp2C","sparse_above_average","exp2C_sub073",500,"test",252,250,235,-15
"1757","exp2C","sparse_above_average","exp2C_sub074",500,"training",252,20,250,230
"1758","exp2C","sparse_above_average","exp2C_sub074",500,"test",252,250,200,-50
"1759","exp2C","sparse_above_average","exp2C_sub075",500,"training",252,50,230,180
"1760","exp2C","sparse_above_average","exp2C_sub075",500,"test",252,230,300,70
"1761","exp2C","sparse_above_average","exp2C_sub076",500,"training",252,100,245,145
"1762","exp2C","sparse_above_average","exp2C_sub076",500,"test",252,250,235,-15
"1763","exp2C","sparse_above_average","exp2C_sub077",500,"training",252,60,200,140
"1764","exp2C","sparse_above_average","exp2C_sub077",500,"test",252,250,250,0
"1765","exp2C","sparse_above_average","exp2C_sub078",500,"training",252,250,250,0
"1766","exp2C","sparse_above_average","exp2C_sub078",500,"test",252,250,280,30
"1767","exp2C","sparse_above_average","exp2C_sub079",500,"training",252,50,250,200
"1768","exp2C","sparse_above_average","exp2C_sub079",500,"test",252,250,250,0
"1769","exp2C","sparse_above_average","exp2C_sub080",500,"training",252,20,250,230
"1770","exp2C","sparse_above_average","exp2C_sub080",500,"test",252,250,250,0
"1771","exp2C","sparse_above_average","exp2C_sub081",500,"training",252,100,250,150
"1772","exp2C","sparse_above_average","exp2C_sub081",500,"test",252,250,250,0
"1773","exp2C","sparse_above_average","exp2C_sub082",500,"training",252,200,250,50
"1774","exp2C","sparse_above_average","exp2C_sub082",500,"test",252,250,275,25
"1775","exp2C","sparse_above_average","exp2C_sub083",500,"training",252,50,260,210
"1776","exp2C","sparse_above_average","exp2C_sub083",500,"test",252,215,245,30
"1777","exp2C","sparse_above_average","exp2C_sub084",500,"training",252,100,240,140
"1778","exp2C","sparse_above_average","exp2C_sub084",500,"test",252,230,280,50
"1779","exp2C","sparse_above_average","exp2C_sub085",500,"training",252,250,240,-10
"1780","exp2C","sparse_above_average","exp2C_sub085",500,"test",252,245,250,5
"1781","exp2C","sparse_above_average","exp2C_sub086",500,"training",252,100,255,155
"1782","exp2C","sparse_above_average","exp2C_sub086",500,"test",252,255,275,20
"1783","exp2C","sparse_above_average","exp2C_sub087",500,"training",252,200,250,50
"1784","exp2C","sparse_above_average","exp2C_sub087",500,"test",252,255,275,20
"1785","exp2C","sparse_above_average","exp2C_sub088",500,"training",252,150,250,100
"1786","exp2C","sparse_above_average","exp2C_sub088",500,"test",252,250,270,20
"1787","exp2C","sparse_above_average","exp2C_sub089",500,"training",252,50,250,200
"1788","exp2C","sparse_above_average","exp2C_sub089",500,"test",252,255,285,30
"1789","exp2C","sparse_above_average","exp2C_sub090",500,"training",252,100,300,200
"1790","exp2C","sparse_above_average","exp2C_sub090",500,"test",252,300,250,-50
"1791","exp2C","sparse_above_average","exp2C_sub091",500,"training",252,150,255,105
"1792","exp2C","sparse_above_average","exp2C_sub091",500,"test",252,255,275,20
"1793","exp2C","sparse_above_average","exp2C_sub092",500,"training",252,50,220,170
"1794","exp2C","sparse_above_average","exp2C_sub092",500,"test",252,250,280,30
"1795","exp2C","sparse_above_average","exp2C_sub093",500,"training",252,20,220,200
"1796","exp2C","sparse_above_average","exp2C_sub093",500,"test",252,240,250,10
"1797","exp2C","sparse_above_average","exp2C_sub094",500,"training",252,300,230,-70
"1798","exp2C","sparse_above_average","exp2C_sub094",500,"test",252,240,290,50
"1799","exp2C","sparse_above_average","exp2C_sub095",500,"training",252,250,250,0
"1800","exp2C","sparse_above_average","exp2C_sub095",500,"test",252,250,245,-5
"1801","exp2C","sparse_above_average","exp2C_sub096",500,"training",252,25,250,225
"1802","exp2C","sparse_above_average","exp2C_sub096",500,"test",252,250,235,-15
"1803","exp2C","sparse_above_average","exp2C_sub097",500,"training",252,25,250,225
"1804","exp2C","sparse_above_average","exp2C_sub097",500,"test",252,250,225,-25
"1805","exp2C","sparse_above_average","exp2C_sub098",500,"training",252,100,222,122
"1806","exp2C","sparse_above_average","exp2C_sub098",500,"test",252,222,300,78
"1807","exp2C","sparse_above_average","exp2C_sub099",500,"training",252,150,230,80
"1808","exp2C","sparse_above_average","exp2C_sub099",500,"test",252,240,250,10
"1809","exp2C","sparse_above_average","exp2C_sub100",500,"training",252,200,250,50
"1810","exp2C","sparse_above_average","exp2C_sub100",500,"test",252,250,265,15
"1811","exp2C","sparse_above_average","exp2C_sub101",500,"training",252,250,255,5
"1812","exp2C","sparse_above_average","exp2C_sub101",500,"test",252,260,260,0
"1813","supp","sparse_below_average","supp_sub001",300,"training",100.325,55,94,39
"1814","supp","sparse_below_average","supp_sub001",300,"test",108,106,105,-1
"1815","supp","sparse_below_average","supp_sub002",300,"training",100.325,30,75,45
"1816","supp","sparse_below_average","supp_sub002",300,"test",108.65,95,90,-5
"1817","supp","sparse_below_average","supp_sub003",300,"training",100.325,20,95,75
"1818","supp","sparse_below_average","supp_sub003",300,"test",108.65,100,95,-5
"1819","supp","sparse_below_average","supp_sub004",300,"training",100.325,60,104,44
"1820","supp","sparse_below_average","supp_sub004",300,"test",108.65,93,98,5
"1821","supp","sparse_below_average","supp_sub005",300,"training",100.325,80,96,16
"1822","supp","sparse_below_average","supp_sub005",300,"test",108.65,102,105,3
"1823","supp","sparse_below_average","supp_sub006",300,"training",100.325,28,135,107
"1824","supp","sparse_below_average","supp_sub006",300,"test",108,78,124,46
"1825","supp","sparse_below_average","supp_sub007",300,"training",100.325,30,110,80
"1826","supp","sparse_below_average","supp_sub007",300,"test",108,100,75,-25
"1827","supp","sparse_below_average","supp_sub008",300,"training",100.325,50,84,34
"1828","supp","sparse_below_average","supp_sub008",300,"test",108.65,94,128,34
"1829","supp","sparse_below_average","supp_sub009",300,"training",100.325,50,105,55
"1830","supp","sparse_below_average","supp_sub009",300,"test",108.65,105,110,5
"1831","supp","sparse_below_average","supp_sub010",300,"training",100.325,121,147,26
"1832","supp","sparse_below_average","supp_sub010",300,"test",108.65,103,175,72
"1833","supp","sparse_below_average","supp_sub011",300,"training",100.325,100,100,0
"1834","supp","sparse_below_average","supp_sub011",300,"test",108,100,105,5
"1835","supp","sparse_below_average","supp_sub012",300,"training",100.325,60,102,42
"1836","supp","sparse_below_average","supp_sub012",300,"test",108.65,100,101,1
"1837","supp","sparse_below_average","supp_sub013",300,"training",100.325,50,101,51
"1838","supp","sparse_below_average","supp_sub013",300,"test",108.65,101,110,9
"1839","supp","sparse_below_average","supp_sub014",300,"training",100.325,200,101,-99
"1840","supp","sparse_below_average","supp_sub014",300,"test",108.65,125,123,-2
"1841","supp","sparse_below_average","supp_sub015",300,"training",100.325,104,89,-15
"1842","supp","sparse_below_average","supp_sub015",300,"test",108,101,109,8
"1843","supp","sparse_below_average","supp_sub016",300,"training",100.325,101,105,4
"1844","supp","sparse_below_average","supp_sub016",300,"test",108.65,100,115,15
"1845","supp","sparse_below_average","supp_sub017",300,"training",100.325,61,118,57
"1846","supp","sparse_below_average","supp_sub017",300,"test",108.65,96,104,8
"1847","supp","sparse_below_average","supp_sub018",300,"training",100.325,178,105,-73
"1848","supp","sparse_below_average","supp_sub018",300,"test",108.65,105,125,20
"1849","supp","sparse_below_average","supp_sub019",300,"training",100.325,50,93,43
"1850","supp","sparse_below_average","supp_sub019",300,"test",108.65,95,98,3
"1851","supp","sparse_above_average","supp_sub020",300,"training",100.325,10,95,85
"1852","supp","sparse_above_average","supp_sub020",300,"test",111.65,98,100,2
"1853","supp","sparse_above_average","supp_sub021",300,"training",100.325,10,95,85
"1854","supp","sparse_above_average","supp_sub021",300,"test",111.65,85,120,35
"1855","supp","sparse_above_average","supp_sub022",300,"training",100.325,40,100,60
"1856","supp","sparse_above_average","supp_sub022",300,"test",112.512820512821,120,115,-5
"1857","supp","sparse_above_average","supp_sub023",300,"training",100.325,186,94,-92
"1858","supp","sparse_above_average","supp_sub023",300,"test",111.65,96,116,20
"1859","supp","sparse_above_average","supp_sub024",300,"training",100.325,34,104,70
"1860","supp","sparse_above_average","supp_sub024",300,"test",111.65,109,143,34
"1861","supp","sparse_above_average","supp_sub025",300,"training",100.325,32,98,66
"1862","supp","sparse_above_average","supp_sub025",300,"test",111.65,100,117,17
"1863","supp","sparse_above_average","supp_sub026",300,"training",100.325,31,109,78
"1864","supp","sparse_above_average","supp_sub026",300,"test",112.512820512821,100,101,1
"1865","supp","sparse_above_average","supp_sub027",300,"training",100.325,22,115,93
"1866","supp","sparse_above_average","supp_sub027",300,"test",111.65,100,130,30
"1867","supp","sparse_above_average","supp_sub028",300,"training",100.325,99,108,9
"1868","supp","sparse_above_average","supp_sub028",300,"test",111.65,100,109,9
"1869","supp","sparse_above_average","supp_sub029",300,"training",100.325,50,100,50
"1870","supp","sparse_above_average","supp_sub029",300,"test",111.65,100,125,25
"1871","supp","sparse_above_average","supp_sub030",300,"training",100.325,117,104,-13
"1872","supp","sparse_above_average","supp_sub030",300,"test",112.512820512821,106,106,0
"1873","supp","sparse_above_average","supp_sub031",300,"training",100.325,50,120,70
"1874","supp","sparse_above_average","supp_sub031",300,"test",111.65,94,140,46
"1875","supp","sparse_above_average","supp_sub032",300,"training",100.325,61,224,163
"1876","supp","sparse_above_average","supp_sub032",300,"test",112.512820512821,106,215,109
"1877","supp","sparse_above_average","supp_sub033",300,"training",100.325,119,86,-33
"1878","supp","sparse_above_average","supp_sub033",300,"test",112.512820512821,101,158,57
"1879","supp","sparse_above_average","supp_sub034",300,"training",100.325,90,99,9
"1880","supp","sparse_above_average","supp_sub034",300,"test",111.65,112,98,-14
"1881","supp","sparse_above_average","supp_sub035",300,"training",100.325,147,95,-52
"1882","supp","sparse_above_average","supp_sub035",300,"test",111.65,90,110,20
"1883","supp","sparse_above_average","supp_sub036",300,"training",100.325,124,202,78
"1884","supp","sparse_above_average","supp_sub036",300,"test",112.512820512821,114,149,35
"1885","supp","sparse_above_average","supp_sub037",300,"training",100.325,239,91,-148
"1886","supp","sparse_above_average","supp_sub037",300,"test",112.512820512821,109,118,9
"1887","supp","sparse_above_average","supp_sub038",300,"training",100.325,117,128,11
"1888","supp","sparse_above_average","supp_sub038",300,"test",111.65,113,114,1
"1889","supp","sparse_above_average","supp_sub039",300,"training",100.325,50,98,48
"1890","supp","sparse_above_average","supp_sub039",300,"test",111.65,120,118,-2
